AAAAACCCATGCACTTAGA -> AAAACCCATGCACTTAGAG
AAAAATATCTCTGTTCCCG -> AAAATATCTCTGTTCCCGC
AAAAATCAACTTGGGCCTG -> AAAATCAACTTGGGCCTGA
AAAACATGAGTTATCATTT -> AAACATGAGTTATCATTTT
AAAACCCATGCACTTAGAG -> AAACCCATGCACTTAGAGA
AAAATATCTCTGTTCCCGC -> AAATATCTCTGTTCCCGCG
AAAATCAACTTGGGCCTGA -> AAATCAACTTGGGCCTGAC
AAACATGAGTTATCATTTT -> AACATGAGTTATCATTTTA
AAACCCATGCACTTAGAGA -> AACCCATGCACTTAGAGAC
AAACCTATATCGGAGCGAT -> AACCTATATCGGAGCGATC
AAACGCCCGCCTATCGTTT -> AACGCCCGCCTATCGTTTT
AAACTGCTATATCATCCAA -> AACTGCTATATCATCCAAC
AAACTGTTGATTAAGTGTC -> AACTGTTGATTAAGTGTCG
AAAGACCACCTATAACACA -> AAGACCACCTATAACACAT
AAAGCCGTCTAGAATCAGA -> AAGCCGTCTAGAATCAGAG
AAAGGCCTCACAAACTGCT -> AAGGCCTCACAAACTGCTA
AAAGGGAACTACCCCTGTT -> AAGGGAACTACCCCTGTTT
AAAGGGACCCCGCGATGGG -> AAGGGACCCCGCGATGGGC
AAAGTTGTGATTAATATCG -> AAGTTGTGATTAATATCGC
AAATATCTCTGTTCCCGCG -> AATATCTCTGTTCCCGCGT
AAATCAACTTGGGCCTGAC -> AATCAACTTGGGCCTGACT
AACAACCTCTTCAATTTTT -> ACAACCTCTTCAATTTTTC
AACACATACATGAAACCTA -> ACACATACATGAAACCTAT
AACAGGCGCACTACGGGCG -> ACAGGCGCACTACGGGCGT
AACAGTACCATCTCCTTGA -> ACAGTACCATCTCCTTGAG
AACAGTCCTAATCGAGCTA -> ACAGTCCTAATCGAGCTAC
AACATGAGTTATCATTTTA -> ACATGAGTTATCATTTTAA
AACCATAAGTGGCCGGACG -> ACCATAAGTGGCCGGACGT
AACCATAATGTACGTTGAG -> ACCATAATGTACGTTGAGG
AACCCATGCACTTAGAGAC -> ACCCATGCACTTAGAGACC
AACCCGAGGGGGGGGCCGT -> ACCCGAGGGGGGGGCCGTA
AACCGATGGATAACGCATT -> ACCGATGGATAACGCATTG
AACCTATATCGGAGCGATC -> ACCTATATCGGAGCGATCC
AACCTCTTCAATTTTTCTC -> ACCTCTTCAATTTTTCTCG
AACCTGCATCATTCTAGCT -> ACCTGCATCATTCTAGCTC
AACGAGTCAGGCCGGCTAT -> ACGAGTCAGGCCGGCTATA
AACGCAGGACATCCTGATT -> ACGCAGGACATCCTGATTT
AACGCATTGACTCCTCAAA -> ACGCATTGACTCCTCAAAA
AACGCCCGCCTATCGTTTT -> ACGCCCGCCTATCGTTTTT
AACGCGTGGATCATGTCCA -> ACGCGTGGATCATGTCCAG
AACGGCACTATTACGCGGG -> ACGGCACTATTACGCGGGG
AACGGCTTCAAAGACCACC -> ACGGCTTCAAAGACCACCT
AACTACACACACCACGAAG -> ACTACACACACCACGAAGT
AACTACCCCTGTTTTCTGA -> ACTACCCCTGTTTTCTGAA
AACTGCTATATCATCCAAC -> ACTGCTATATCATCCAACA
AACTGTCCGTGATGGAACG -> ACTGTCCGTGATGGAACGC
AACTGTTGATTAAGTGTCG -> ACTGTTGATTAAGTGTCGA
AACTTACGCATACCATTAC -> ACTTACGCATACCATTACT
AACTTGGGCCTGACTCGAG -> ACTTGGGCCTGACTCGAGC
AAGACCACCTATAACACAT -> AGACCACCTATAACACATA
AAGACTACTACGGAGTTTC -> AGACTACTACGGAGTTTCA
AAGCAATTTTTTGCAGCTT -> AGCAATTTTTTGCAGCTTC
AAGCAGCTTAGTTCAGCGC -> AGCAGCTTAGTTCAGCGCG
AAGCCGTCTAGAATCAGAG -> AGCCGTCTAGAATCAGAGC
AAGCCTCCTCGAGACGCCA -> AGCCTCCTCGAGACGCCAT
AAGCCTGACCGGACAAAGG -> AGCCTGACCGGACAAAGGC
AAGCGAATGTTTGCAGAAA -> AGCGAATGTTTGCAGAAAG
AAGCGTGTTTAGTCTCTCC -> AGCGTGTTTAGTCTCTCCG
AAGCTAGGCAGCGGCGTCC -> AGCTAGGCAGCGGCGTCCA
AAGCTAGGTAGACCTCCCG -> AGCTAGGTAGACCTCCCGT
AAGCTGAGCGGCGCTGTCA -> AGCTGAGCGGCGCTGTCAA
AAGGCCTCACAAACTGCTA -> AGGCCTCACAAACTGCTAT
AAGGGAACTACCCCTGTTT -> AGGGAACTACCCCTGTTTT
AAGGGACCCCGCGATGGGC -> AGGGACCCCGCGATGGGCA
AAGGGCAGGACGAGACATC -> AGGGCAGGACGAGACATCA
AAGGTAAAGCCGTCTAGAA -> AGGTAAAGCCGTCTAGAAT
AAGGTTATGCATTTACCAC -> AGGTTATGCATTTACCACA
AAGTACTTCTGGTGTGATA -> AGTACTTCTGGTGTGATAT
AAGTCGCAGCGAAGAGACG -> AGTCGCAGCGAAGAGACGG
AAGTGCTCTTTCTTCTCTC -> AGTGCTCTTTCTTCTCTCT
AAGTGGCCGGACGTAAAAA -> AGTGGCCGGACGTAAAAAT
AAGTGTCGAGAATCAGTCT -> AGTGTCGAGAATCAGTCTA
AAGTTCTATATCGGAGCGA -> AGTTCTATATCGGAGCGAT
AAGTTGTGATTAATATCGC -> AGTTGTGATTAATATCGCC
AATATCGCCGACCAACCAT -> ATATCGCCGACCAACCATA
AATATCTCTGTTCCCGCGT -> ATATCTCTGTTCCCGCGTT
AATCAACTTGGGCCTGACT -> ATCAACTTGGGCCTGACTC
AATCAAGCCTCCTCGAGAC -> ATCAAGCCTCCTCGAGACG
AATCACACATATCCTGGCG -> ATCACACATATCCTGGCGG
AATCAGAGCCTAGCTGTCG -> ATCAGAGCCTAGCTGTCGT
AATCAGTCTACCCAGTGAT -> ATCAGTCTACCCAGTGATC
AATCATTCTTTAGGCTAGA -> ATCATTCTTTAGGCTAGAG
AATCGAGCTACCAACGCAG -> ATCGAGCTACCAACGCAGG
AATCTGAAACTGTTGATTA -> ATCTGAAACTGTTGATTAA
AATGACATAATGTCTCGCT -> ATGACATAATGTCTCGCTT
AATGACCACCATTTAGAGG -> ATGACCACCATTTAGAGGC
AATGTAAGCAATTTTTTGC -> ATGTAAGCAATTTTTTGCA
AATGTACGTTGAGGGACTT -> ATGTACGTTGAGGGACTTT
AATGTCTCGCTTTACGCAC -> ATGTCTCGCTTTACGCACT
AATGTTTGCAGAAAGGGAC -> ATGTTTGCAGAAAGGGACC
AATTCACCATTTAGGAATT -> ATTCACCATTTAGGAATTC
AATTCCCCCGTTGGCAATT -> ATTCCCCCGTTGGCAATTC
AATTCGACACCCATCGGAG -> ATTCGACACCCATCGGAGG
AATTCGTACCCAACAGTAC -> ATTCGTACCCAACAGTACC
AATTTCCTCGGAAAACATG -> ATTTCCTCGGAAAACATGA
AATTTCGCTCGGATCCTCG -> ATTTCGCTCGGATCCTCGT
AATTTTCTTCTGGGTGGTT -> ATTTTCTTCTGGGTGGTTG
AATTTTTCTCGCAAGCCTG -> ATTTTTCTCGCAAGCCTGA
AATTTTTTGCAGCTTCTGT -> ATTTTTTGCAGCTTCTGTT
AATTTTTTGGGCCGGCCCA -> ATTTTTTGGGCCGGCCCAG
ACAAACTGCTATATCATCC -> CAAACTGCTATATCATCCA
ACAAAGGCCTCACAAACTG -> CAAAGGCCTCACAAACTGC
ACAACCTCTTCAATTTTTC -> CAACCTCTTCAATTTTTCT
ACAAGCTAGGCAGCGGCGT -> CAAGCTAGGCAGCGGCGTC
ACAATTTCGCTCGGATCCT -> CAATTTCGCTCGGATCCTC
ACACAAGCTAGGCAGCGGC -> CACAAGCTAGGCAGCGGCG
ACACACACCACGAAGTGCT -> CACACACCACGAAGTGCTC
ACACACAGGGTCCTTGTAG -> CACACAGGGTCCTTGTAGA
ACACACCACGAAGTGCTCT -> CACACCACGAAGTGCTCTT
ACACAGGGTCCTTGTAGAT -> CACAGGGTCCTTGTAGATT
ACACATACATGAAACCTAT -> CACATACATGAAACCTATA
ACACATATCCTGGCGGAGT -> CACATATCCTGGCGGAGTT
ACACCACGAAGTGCTCTTT -> CACCACGAAGTGCTCTTTC
ACACCCATCGGAGGCCTAT -> CACCCATCGGAGGCCTATT
ACACGATTATGCAAGCTAG -> CACGATTATGCAAGCTAGG
ACACGGTCCGCTGCCCGGC -> CACGGTCCGCTGCCCGGCT
ACACTAAGCGTGTTTAGTC -> CACTAAGCGTGTTTAGTCT
ACAGCCGTTTGTAGAGCTG -> CAGCCGTTTGTAGAGCTGG
ACAGGCATCGGACAGCCGT -> CAGGCATCGGACAGCCGTT
ACAGGCGCACTACGGGCGT -> CAGGCGCACTACGGGCGTC
ACAGGGTCCTTGTAGATTA -> CAGGGTCCTTGTAGATTAG
ACAGTACCATCTCCTTGAG -> CAGTACCATCTCCTTGAGC
ACAGTCCTAATCGAGCTAC -> CAGTCCTAATCGAGCTACC
ACAGTTCGTCGGATTAAGT -> CAGTTCGTCGGATTAAGTC
ACATAATGTCTCGCTTTAC -> CATAATGTCTCGCTTTACG
ACATACATGAAACCTATAT -> CATACATGAAACCTATATC
ACATAGCTAGAGGGGGCAG -> CATAGCTAGAGGGGGCAGG
ACATATCCTGGCGGAGTTT -> CATATCCTGGCGGAGTTTT
ACATCACACGATTATGCAA -> CATCACACGATTATGCAAG
ACATCCTGATTTAGGTACT -> CATCCTGATTTAGGTACTA
ACATGAAACCTATATCGGA -> CATGAAACCTATATCGGAG
ACATGAGTTATCATTTTAA -> CATGAGTTATCATTTTAAA
ACATTATCGAAGGGCAGGA -> CATTATCGAAGGGCAGGAC
ACCAACCATAATGTACGTT -> CCAACCATAATGTACGTTG
ACCAACGCAGGACATCCTG -> CCAACGCAGGACATCCTGA
ACCACATAGCTAGAGGGGG -> CCACATAGCTAGAGGGGGC
ACCACCATTTAGAGGCGCA -> CCACCATTTAGAGGCGCAG
ACCACCTATAACACATACA -> CCACCTATAACACATACAT
ACCACGAAGTGCTCTTTCT -> CCACGAAGTGCTCTTTCTT
ACCAGGTGGTAGAATCTGA -> CCAGGTGGTAGAATCTGAA
ACCATAAGTGGCCGGACGT -> CCATAAGTGGCCGGACGTA
ACCATAATGTACGTTGAGG -> CCATAATGTACGTTGAGGG
ACCATCTCCTTGAGCCTAT -> CCATCTCCTTGAGCCTATA
ACCATTACTGACCCACCAG -> CCATTACTGACCCACCAGG
ACCATTTAGAGGCGCAGAG -> CCATTTAGAGGCGCAGAGA
ACCATTTAGGAATTCGACA -> CCATTTAGGAATTCGACAC
ACCCAACAGTACCATCTCC -> CCCAACAGTACCATCTCCT
ACCCACCAGGTGGTAGAAT -> CCCACCAGGTGGTAGAATC
ACCCAGTGATCCTTATCAG -> CCCAGTGATCCTTATCAGA
ACCCATAGGTCGTTCTCTG -> CCCATAGGTCGTTCTCTGT
ACCCATCGGAGGCCTATTT -> CCCATCGGAGGCCTATTTA
ACCCATGCACTTAGAGACC -> CCCATGCACTTAGAGACCC
ACCCCGCGATGGGCAACTT -> CCCCGCGATGGGCAACTTA
ACCCCTGTTTTCTGAACCT -> CCCCTGTTTTCTGAACCTG
ACCCGAGGGGGGGGCCGTA -> CCCGAGGGGGGGGCCGTAG
ACCCTATGGGTTTATGGCC -> CCCTATGGGTTTATGGCCC
ACCGATGGATAACGCATTG -> CCGATGGATAACGCATTGA
ACCGGACAAAGGCCTCACA -> CCGGACAAAGGCCTCACAA
ACCGTTTGACCTCTGCGTC -> CCGTTTGACCTCTGCGTCG
ACCTATAACACATACATGA -> CCTATAACACATACATGAA
ACCTATATCGGAGCGATCC -> CCTATATCGGAGCGATCCT
ACCTCCCGTAGATGTTTCA -> CCTCCCGTAGATGTTTCAT
ACCTCTACCCTATGGGTTT -> CCTCTACCCTATGGGTTTA
ACCTCTGCGTCGTCTAGCC -> CCTCTGCGTCGTCTAGCCA
ACCTCTTCAATTTTTCTCG -> CCTCTTCAATTTTTCTCGC
ACCTGCATCATTCTAGCTC -> CCTGCATCATTCTAGCTCG
ACGAAGTGCTCTTTCTTCT -> CGAAGTGCTCTTTCTTCTC
ACGAGACATCACACGATTA -> CGAGACATCACACGATTAT
ACGAGCGGGGGGGCGAATT -> CGAGCGGGGGGGCGAATTC
ACGAGTCAGGCCGGCTATA -> CGAGTCAGGCCGGCTATAT
ACGATTATGCAAGCTAGGT -> CGATTATGCAAGCTAGGTA
ACGCACTCGTCCAGTCCTT -> CGCACTCGTCCAGTCCTTG
ACGCAGGACATCCTGATTT -> CGCAGGACATCCTGATTTA
ACGCATACCATTACTGACC -> CGCATACCATTACTGACCC
ACGCATATGGGGCAACGGC -> CGCATATGGGGCAACGGCT
ACGCATTGACTCCTCAAAA -> CGCATTGACTCCTCAAAAA
ACGCCATTGCTGCAGTCGG -> CGCCATTGCTGCAGTCGGT
ACGCCCGCCTATCGTTTTT -> CGCCCGCCTATCGTTTTTA
ACGCGAGTGCTCTAATGAC -> CGCGAGTGCTCTAATGACA
ACGCGGGGGATAAAAACCC -> CGCGGGGGATAAAAACCCA
ACGCGTGGATCATGTCCAG -> CGCGTGGATCATGTCCAGT
ACGCTATCGCTAGGAACAA -> CGCTATCGCTAGGAACAAC
ACGGAGTTTCAGCCGCGGT -> CGGAGTTTCAGCCGCGGTT
ACGGCACTATTACGCGGGG -> CGGCACTATTACGCGGGGG
ACGGCAGTTCAACAGGCGC -> CGGCAGTTCAACAGGCGCA
ACGGCTTCAAAGACCACCT -> CGGCTTCAAAGACCACCTA
ACGGGAAGGTTATGCATTT -> CGGGAAGGTTATGCATTTA
ACGGGCGTCGTTTTTCCAA -> CGGGCGTCGTTTTTCCAAC
ACGGTCCGCTGCCCGGCTA -> CGGTCCGCTGCCCGGCTAA
ACGGTCCTCACACTAAGCG -> CGGTCCTCACACTAAGCGT
ACGGTTCGCGCTCAGTAGG -> CGGTTCGCGCTCAGTAGGA
ACGTAAAAATCAACTTGGG -> CGTAAAAATCAACTTGGGC
ACGTCACGCGAGTGCTCTA -> CGTCACGCGAGTGCTCTAA
ACGTCTTCTGGGTGGTTGT -> CGTCTTCTGGGTGGTTGTG
ACGTTGAGGGACTTTTATT -> CGTTGAGGGACTTTTATTT
ACTAAGCGTGTTTAGTCTC -> CTAAGCGTGTTTAGTCTCT
ACTACACACACCACGAAGT -> CTACACACACCACGAAGTG
ACTACCCCTGTTTTCTGAA -> CTACCCCTGTTTTCTGAAC
ACTACGGAGTTTCAGCCGC -> CTACGGAGTTTCAGCCGCG
ACTACGGGCGTCGTTTTTC -> CTACGGGCGTCGTTTTTCC
ACTACTACGGAGTTTCAGC -> CTACTACGGAGTTTCAGCC
ACTAGAAGCGAATGTTTGC -> CTAGAAGCGAATGTTTGCA
ACTATATCGGAGCGATCCT -> CTATATCGGAGCGATCCTA
ACTATCGTCCCAAGCTGAG -> CTATCGTCCCAAGCTGAGC
ACTATTACGCGGGGGATAA -> CTATTACGCGGGGGATAAA
ACTCCTCAAAAATATCTCT -> CTCCTCAAAAATATCTCTG
ACTCCTCAGTGTCGGACAC -> CTCCTCAGTGTCGGACACA
ACTCGAGCTTCTGGTTAGA -> CTCGAGCTTCTGGTTAGAG
ACTCGTCCAGTCCTTGTCA -> CTCGTCCAGTCCTTGTCAC
ACTGACCCACCAGGTGGTA -> CTGACCCACCAGGTGGTAG
ACTGCTATATCATCCAACA -> CTGCTATATCATCCAACAG
ACTGTCCGTGATGGAACGC -> CTGTCCGTGATGGAACGCG
ACTGTTGATTAAGTGTCGA -> CTGTTGATTAAGTGTCGAG
ACTTACGCATACCATTACT -> CTTACGCATACCATTACTG
ACTTACTTCCACGGCAGTT -> CTTACTTCCACGGCAGTTC
ACTTAGAGACCCATAGGTC -> CTTAGAGACCCATAGGTCG
ACTTCCACGGCAGTTCAAC -> CTTCCACGGCAGTTCAACA
ACTTCTGGTGTGATATACT -> CTTCTGGTGTGATATACTT
ACTTGGGCCTGACTCGAGC -> CTTGGGCCTGACTCGAGCT
ACTTGTCCTCTCTACATTA -> CTTGTCCTCTCTACATTAT
ACTTTTATTTCCGTGGTAA -> CTTTTATTTCCGTGGTAAC
AGAAAGGGACCCCGCGATG -> GAAAGGGACCCCGCGATGG
AGAAGCGAATGTTTGCAGA -> GAAGCGAATGTTTGCAGAA
AGAAGGTAAAGCCGTCTAG -> GAAGGTAAAGCCGTCTAGA
AGAATCAGAGCCTAGCTGT -> GAATCAGAGCCTAGCTGTC
AGAATCAGTCTACCCAGTG -> GAATCAGTCTACCCAGTGA
AGAATCTGAAACTGTTGAT -> GAATCTGAAACTGTTGATT
AGACAATTTCGCTCGGATC -> GACAATTTCGCTCGGATCC
AGACACACAGGGTCCTTGT -> GACACACAGGGTCCTTGTA
AGACATCACACGATTATGC -> GACATCACACGATTATGCA
AGACCACCTATAACACATA -> GACCACCTATAACACATAC
AGACCCATAGGTCGTTCTC -> GACCCATAGGTCGTTCTCT
AGACCTCCCGTAGATGTTT -> GACCTCCCGTAGATGTTTC
AGACGCCATTGCTGCAGTC -> GACGCCATTGCTGCAGTCG
AGACGCTATCGCTAGGAAC -> GACGCTATCGCTAGGAACA
AGACTACTACGGAGTTTCA -> GACTACTACGGAGTTTCAG
AGACTTACTTCCACGGCAG -> GACTTACTTCCACGGCAGT
AGAGACAATTTCGCTCGGA -> GAGACAATTTCGCTCGGAT
AGAGACCCATAGGTCGTTC -> GAGACCCATAGGTCGTTCT
AGAGACGCTATCGCTAGGA -> GAGACGCTATCGCTAGGAA
AGAGACTTACTTCCACGGC -> GAGACTTACTTCCACGGCA
AGAGATAGGCATTCGTGCG -> GAGATAGGCATTCGTGCGG
AGAGCCTAGCTGTCGTGCC -> GAGCCTAGCTGTCGTGCCA
AGAGCGCTTCTGGGTGGTT -> GAGCGCTTCTGGGTGGTTG
AGAGCTATTCTACCGTTTG -> GAGCTATTCTACCGTTTGA
AGAGCTGGGCACGGGAAGG -> GAGCTGGGCACGGGAAGGT
AGAGGCGCAGAGACAATTT -> GAGGCGCAGAGACAATTTC
AGAGGGGGCAGGGTGCCCC -> GAGGGGGCAGGGTGCCCCC
AGATAAGTTCTATATCGGA -> GATAAGTTCTATATCGGAG
AGATAGGCATTCGTGCGGT -> GATAGGCATTCGTGCGGTA
AGATGTTTCATAATTTTTT -> GATGTTTCATAATTTTTTG
AGATTAGGGCCTATGGCCT -> GATTAGGGCCTATGGCCTT
AGATTTCTCGTTGTCTCGT -> GATTTCTCGTTGTCTCGTC
AGCAACCCGAGGGGGGGGC -> GCAACCCGAGGGGGGGGCC
AGCAAGTACTTCTGGTGTG -> GCAAGTACTTCTGGTGTGA
AGCAATTTTTTGCAGCTTC -> GCAATTTTTTGCAGCTTCT
AGCAGCTTAGTTCAGCGCG -> GCAGCTTAGTTCAGCGCGC
AGCCAGTTTCCAGTAATTC -> GCCAGTTTCCAGTAATTCG
AGCCGCGGTTGGGCTGTAT -> GCCGCGGTTGGGCTGTATC
AGCCGTCTAGAATCAGAGC -> GCCGTCTAGAATCAGAGCC
AGCCGTTTGTAGAGCTGGG -> GCCGTTTGTAGAGCTGGGC
AGCCTAGCTGTCGTGCCAT -> GCCTAGCTGTCGTGCCATA
AGCCTATATGGATCCGTCC -> GCCTATATGGATCCGTCCC
AGCCTCCTCGAGACGCCAT -> GCCTCCTCGAGACGCCATT
AGCCTGACCGGACAAAGGC -> GCCTGACCGGACAAAGGCC
AGCGAATGTTTGCAGAAAG -> GCGAATGTTTGCAGAAAGG
AGCGATCCTAGTTCAATTT -> GCGATCCTAGTTCAATTTT
AGCGATCCTCTTCGAGAGC -> GCGATCCTCTTCGAGAGCG
AGCGATCCTGCTCGGAGGG -> GCGATCCTGCTCGGAGGGT
AGCGATCCTTGGATCGACG -> GCGATCCTTGGATCGACGT
AGCGCGCACGAGCGGGGGG -> GCGCGCACGAGCGGGGGGG
AGCGCTTCTGGGTGGTTGT -> GCGCTTCTGGGTGGTTGTG
AGCGGCGCTGTCAAAGTTG -> GCGGCGCTGTCAAAGTTGT
AGCGGCGTCCAATCACACA -> GCGGCGTCCAATCACACAT
AGCGGGGGGGCGAATTCCC -> GCGGGGGGGCGAATTCCCC
AGCGTGTTTAGTCTCTCCG -> GCGTGTTTAGTCTCTCCGG
AGCTACCAACGCAGGACAT -> GCTACCAACGCAGGACATC
AGCTAGAGGGGGCAGGGTG -> GCTAGAGGGGGCAGGGTGC
AGCTAGGCAGCGGCGTCCA -> GCTAGGCAGCGGCGTCCAA
AGCTAGGTAGACCTCCCGT -> GCTAGGTAGACCTCCCGTA
AGCTATTCTACCGTTTGAC -> GCTATTCTACCGTTTGACC
AGCTCGATGTATCCTGTCC -> GCTCGATGTATCCTGTCCG
AGCTGAGCGGCGCTGTCAA -> GCTGAGCGGCGCTGTCAAA
AGCTGGGCACGGGAAGGTT -> GCTGGGCACGGGAAGGTTA
AGCTGTCGTGCCATATCAC -> GCTGTCGTGCCATATCACT
AGCTTAGTTCAGCGCGCAC -> GCTTAGTTCAGCGCGCACG
AGCTTCTGGTTAGAGACTT -> GCTTCTGGTTAGAGACTTA
AGCTTCTGTTTTTGCAATG -> GCTTCTGTTTTTGCAATGA
AGGAACAACCTCTTCAATT -> GGAACAACCTCTTCAATTT
AGGAAGCAGCTTAGTTCAG -> GGAAGCAGCTTAGTTCAGC
AGGAATTCGACACCCATCG -> GGAATTCGACACCCATCGG
AGGACATCCTGATTTAGGT -> GGACATCCTGATTTAGGTA
AGGACGAGACATCACACGA -> GGACGAGACATCACACGAT
AGGATGTCGCGGAATTTCC -> GGATGTCGCGGAATTTCCT
AGGCAACTGTCCGTGATGG -> GGCAACTGTCCGTGATGGA
AGGCAGCGGCGTCCAATCA -> GGCAGCGGCGTCCAATCAC
AGGCATCGGACAGCCGTTT -> GGCATCGGACAGCCGTTTG
AGGCATTCGTGCGGTATCC -> GGCATTCGTGCGGTATCCG
AGGCCGGCTATATCGGAGC -> GGCCGGCTATATCGGAGCG
AGGCCTATTTAGATAAGTT -> GGCCTATTTAGATAAGTTC
AGGCCTCACAAACTGCTAT -> GGCCTCACAAACTGCTATA
AGGCGCACTACGGGCGTCG -> GGCGCACTACGGGCGTCGT
AGGCGCAGAGACAATTTCG -> GGCGCAGAGACAATTTCGC
AGGCTAGAGACGCTATCGC -> GGCTAGAGACGCTATCGCT
AGGCTGTATGCTGTACCTC -> GGCTGTATGCTGTACCTCT
AGGGAACTACCCCTGTTTT -> GGGAACTACCCCTGTTTTC
AGGGACCCCGCGATGGGCA -> GGGACCCCGCGATGGGCAA
AGGGACGGTCCTCACACTA -> GGGACGGTCCTCACACTAA
AGGGACTTTTATTTCCGTG -> GGGACTTTTATTTCCGTGG
AGGGCAGGACGAGACATCA -> GGGCAGGACGAGACATCAC
AGGGCCTATGGCCTTGCTT -> GGGCCTATGGCCTTGCTTC
AGGGGGCAGGGTGCCCCCG -> GGGGGCAGGGTGCCCCCGA
AGGGGGGGGCCGTAGGTTC -> GGGGGGGGCCGTAGGTTCG
AGGGTCCTTGTAGATTAGG -> GGGTCCTTGTAGATTAGGG
AGGGTCTTCTGGGTGGTTG -> GGGTCTTCTGGGTGGTTGT
AGGGTGCCCCCGACGGTTC -> GGGTGCCCCCGACGGTTCG
AGGTAAAGCCGTCTAGAAT -> GGTAAAGCCGTCTAGAATC
AGGTACTATATCGGAGCGA -> GGTACTATATCGGAGCGAT
AGGTAGACCTCCCGTAGAT -> GGTAGACCTCCCGTAGATG
AGGTCGTTCTCTGTCGCCT -> GGTCGTTCTCTGTCGCCTT
AGGTGGTAGAATCTGAAAC -> GGTGGTAGAATCTGAAACT
AGGTTATGCATTTACCACA -> GGTTATGCATTTACCACAT
AGGTTCGTAGGCAACTGTC -> GGTTCGTAGGCAACTGTCC
AGTAATTCGTACCCAACAG -> GTAATTCGTACCCAACAGT
AGTACCATCTCCTTGAGCC -> GTACCATCTCCTTGAGCCT
AGTACTTCTGGTGTGATAT -> GTACTTCTGGTGTGATATA
AGTAGGAAGCAGCTTAGTT -> GTAGGAAGCAGCTTAGTTC
AGTCAGGCCGGCTATATCG -> GTCAGGCCGGCTATATCGG
AGTCCGCATCTCCTGTCCC -> GTCCGCATCTCCTGTCCCT
AGTCCTAATCGAGCTACCA -> GTCCTAATCGAGCTACCAA
AGTCCTTGTCACAGTTCGT -> GTCCTTGTCACAGTTCGTC
AGTCGCAGCGAAGAGACGG -> GTCGCAGCGAAGAGACGGC
AGTCGGTCCCCGTCCCCTT -> GTCGGTCCCCGTCCCCTTC
AGTCTACCCAGTGATCCTT -> GTCTACCCAGTGATCCTTA
AGTCTCTCCGGATCGTAAC -> GTCTCTCCGGATCGTAACC
AGTGATCCTTATCAGACAC -> GTGATCCTTATCAGACACA
AGTGCTCTAATGACATAAT -> GTGCTCTAATGACATAATG
AGTGCTCTTTCTTCTCTCT -> GTGCTCTTTCTTCTCTCTG
AGTGGCCGGACGTAAAAAT -> GTGGCCGGACGTAAAAATC
AGTGTCGAGAATCAGTCTA -> GTGTCGAGAATCAGTCTAC
AGTGTCGGACACAAGCTAG -> GTGTCGGACACAAGCTAGG
AGTGTTATAGGGACGGTCC -> GTGTTATAGGGACGGTCCT
AGTTATCATTTTAAAGGGA -> GTTATCATTTTAAAGGGAA
AGTTCAACAGGCGCACTAC -> GTTCAACAGGCGCACTACG
AGTTCAATTTTCTTCTGGG -> GTTCAATTTTCTTCTGGGT
AGTTCAGCGCGCACGAGCG -> GTTCAGCGCGCACGAGCGG
AGTTCGTCGGATTAAGTCG -> GTTCGTCGGATTAAGTCGC
AGTTCTATATCGGAGCGAT -> GTTCTATATCGGAGCGATC
AGTTGTGATTAATATCGCC -> GTTGTGATTAATATCGCCG
AGTTTCAGCCGCGGTTGGG -> GTTTCAGCCGCGGTTGGGC
AGTTTCCAGTAATTCGTAC -> GTTTCCAGTAATTCGTACC
AGTTTTGCCGGCTATCATG -> GTTTTGCCGGCTATCATGT
ATAAAAACCCATGCACTTA -> TAAAAACCCATGCACTTAG
ATAACACATACATGAAACC -> TAACACATACATGAAACCT
ATAACGCATTGACTCCTCA -> TAACGCATTGACTCCTCAA
ATAAGTGGCCGGACGTAAA -> TAAGTGGCCGGACGTAAAA
ATAAGTTCTATATCGGAGC -> TAAGTTCTATATCGGAGCG
ATAATGTACGTTGAGGGAC -> TAATGTACGTTGAGGGACT
ATAATGTCTCGCTTTACGC -> TAATGTCTCGCTTTACGCA
ATAATTTTTTGGGCCGGCC -> TAATTTTTTGGGCCGGCCC
ATACATGAAACCTATATCG -> TACATGAAACCTATATCGG
ATACCATTACTGACCCACC -> TACCATTACTGACCCACCA
ATACGCATATGGGGCAACG -> TACGCATATGGGGCAACGG
ATACTTGTCCTCTCTACAT -> TACTTGTCCTCTCTACATT
ATAGAAGGTAAAGCCGTCT -> TAGAAGGTAAAGCCGTCTA
ATAGCTAGAGGGGGCAGGG -> TAGCTAGAGGGGGCAGGGT
ATAGGCATTCGTGCGGTAT -> TAGGCATTCGTGCGGTATC
ATAGGGACGGTCCTCACAC -> TAGGGACGGTCCTCACACT
ATAGGTCGTTCTCTGTCGC -> TAGGTCGTTCTCTGTCGCC
ATATACTTGTCCTCTCTAC -> TATACTTGTCCTCTCTACA
ATATCACTCCTCAGTGTCG -> TATCACTCCTCAGTGTCGG
ATATCATCCAACAGTCCTA -> TATCATCCAACAGTCCTAA
ATATCCTGGCGGAGTTTTG -> TATCCTGGCGGAGTTTTGC
ATATCGCCGACCAACCATA -> TATCGCCGACCAACCATAA
ATATCGGAGCGATCCTAGT -> TATCGGAGCGATCCTAGTT
ATATCGGAGCGATCCTCTT -> TATCGGAGCGATCCTCTTC
ATATCGGAGCGATCCTGCT -> TATCGGAGCGATCCTGCTC
ATATCGGAGCGATCCTTGG -> TATCGGAGCGATCCTTGGA
ATATCTCTGTTCCCGCGTT -> TATCTCTGTTCCCGCGTTG
ATATGGATCCGTCCCGATA -> TATGGATCCGTCCCGATAC
ATATGGGGCAACGGCTTCA -> TATGGGGCAACGGCTTCAA
ATCAACTTGGGCCTGACTC -> TCAACTTGGGCCTGACTCG
ATCAAGCCTCCTCGAGACG -> TCAAGCCTCCTCGAGACGC
ATCACACATATCCTGGCGG -> TCACACATATCCTGGCGGA
ATCACACGATTATGCAAGC -> TCACACGATTATGCAAGCT
ATCACTCCTCAGTGTCGGA -> TCACTCCTCAGTGTCGGAC
ATCAGACACACAGGGTCCT -> TCAGACACACAGGGTCCTT
ATCAGAGCCTAGCTGTCGT -> TCAGAGCCTAGCTGTCGTG
ATCAGTCTACCCAGTGATC -> TCAGTCTACCCAGTGATCC
ATCATCCAACAGTCCTAAT -> TCATCCAACAGTCCTAATC
ATCATGTACTATCGTCCCA -> TCATGTACTATCGTCCCAA
ATCATGTCCAGTGTTATAG -> TCATGTCCAGTGTTATAGG
ATCATTCTAGCTCGATGTA -> TCATTCTAGCTCGATGTAT
ATCATTCTTTAGGCTAGAG -> TCATTCTTTAGGCTAGAGA
ATCATTTTAAAGGGAACTA -> TCATTTTAAAGGGAACTAC
ATCCAACAGTCCTAATCGA -> TCCAACAGTCCTAATCGAG
ATCCCTGGCCACACGGTCC -> TCCCTGGCCACACGGTCCG
ATCCGGTCACAGGCATCGG -> TCCGGTCACAGGCATCGGA
ATCCGTCCCGATACGCATA -> TCCGTCCCGATACGCATAT
ATCCTAGTTCAATTTTCTT -> TCCTAGTTCAATTTTCTTC
ATCCTCGTTAATCAAGCCT -> TCCTCGTTAATCAAGCCTC
ATCCTCTTCGAGAGCGCTT -> TCCTCTTCGAGAGCGCTTC
ATCCTGATTTAGGTACTAT -> TCCTGATTTAGGTACTATA
ATCCTGCTCGGAGGGTCTT -> TCCTGCTCGGAGGGTCTTC
ATCCTGGCGGAGTTTTGCC -> TCCTGGCGGAGTTTTGCCG
ATCCTGTCCGAGCAACCCG -> TCCTGTCCGAGCAACCCGA
ATCCTTATCAGACACACAG -> TCCTTATCAGACACACAGG
ATCCTTGGATCGACGTCTT -> TCCTTGGATCGACGTCTTC
ATCGAAGGGCAGGACGAGA -> TCGAAGGGCAGGACGAGAC
ATCGACGTCTTCTGGGTGG -> TCGACGTCTTCTGGGTGGT
ATCGAGCTACCAACGCAGG -> TCGAGCTACCAACGCAGGA
ATCGAGGATGTCGCGGAAT -> TCGAGGATGTCGCGGAATT
ATCGATTGGTTTTGTTTAC -> TCGATTGGTTTTGTTTACT
ATCGCCGACCAACCATAAT -> TCGCCGACCAACCATAATG
ATCGCTAGGAACAACCTCT -> TCGCTAGGAACAACCTCTT
ATCGGACAGCCGTTTGTAG -> TCGGACAGCCGTTTGTAGA
ATCGGAGCGATCCTAGTTC -> TCGGAGCGATCCTAGTTCA
ATCGGAGCGATCCTCTTCG -> TCGGAGCGATCCTCTTCGA
ATCGGAGCGATCCTGCTCG -> TCGGAGCGATCCTGCTCGG
ATCGGAGCGATCCTTGGAT -> TCGGAGCGATCCTTGGATC
ATCGGAGGCCTATTTAGAT -> TCGGAGGCCTATTTAGATA
ATCGTAACCATAAGTGGCC -> TCGTAACCATAAGTGGCCG
ATCGTCCCAAGCTGAGCGG -> TCGTCCCAAGCTGAGCGGC
ATCGTTTTTAGCAAGTACT -> TCGTTTTTAGCAAGTACTT
ATCTCCTGTCCCTAGGCTG -> TCTCCTGTCCCTAGGCTGT
ATCTCCTTGAGCCTATATG -> TCTCCTTGAGCCTATATGG
ATCTCTGTTCCCGCGTTGC -> TCTCTGTTCCCGCGTTGCT
ATCTGAAACTGTTGATTAA -> TCTGAAACTGTTGATTAAG
ATGAAACCTATATCGGAGC -> TGAAACCTATATCGGAGCG
ATGACATAATGTCTCGCTT -> TGACATAATGTCTCGCTTT
ATGACCACCATTTAGAGGC -> TGACCACCATTTAGAGGCG
ATGAGTTATCATTTTAAAG -> TGAGTTATCATTTTAAAGG
ATGCAAGCTAGGTAGACCT -> TGCAAGCTAGGTAGACCTC
ATGCACTTAGAGACCCATA -> TGCACTTAGAGACCCATAG
ATGCATTTACCACATAGCT -> TGCATTTACCACATAGCTA
ATGCTGTACCTCTACCCTA -> TGCTGTACCTCTACCCTAT
ATGGAACGCGTGGATCATG -> TGGAACGCGTGGATCATGT
ATGGATAACGCATTGACTC -> TGGATAACGCATTGACTCC
ATGGATCCGTCCCGATACG -> TGGATCCGTCCCGATACGC
ATGGCCCTTTGCTCCCCTA -> TGGCCCTTTGCTCCCCTAA
ATGGCCTTGCTTCTGGAAT -> TGGCCTTGCTTCTGGAATC
ATGGGCAACTTACGCATAC -> TGGGCAACTTACGCATACC
ATGGGGCAACGGCTTCAAA -> TGGGGCAACGGCTTCAAAG
ATGGGTTTATGGCCCTTTG -> TGGGTTTATGGCCCTTTGC
ATGTAAGCAATTTTTTGCA -> TGTAAGCAATTTTTTGCAG
ATGTACGTTGAGGGACTTT -> TGTACGTTGAGGGACTTTT
ATGTACTATCGTCCCAAGC -> TGTACTATCGTCCCAAGCT
ATGTATCCTGTCCGAGCAA -> TGTATCCTGTCCGAGCAAC
ATGTCCAGTGTTATAGGGA -> TGTCCAGTGTTATAGGGAC
ATGTCGCGGAATTTCCTCG -> TGTCGCGGAATTTCCTCGG
ATGTCTCGCTTTACGCACT -> TGTCTCGCTTTACGCACTC
ATGTTTCATAATTTTTTGG -> TGTTTCATAATTTTTTGGG
ATGTTTGCAGAAAGGGACC -> TGTTTGCAGAAAGGGACCC
ATTAAGTCGCAGCGAAGAG -> TTAAGTCGCAGCGAAGAGA
ATTAAGTGTCGAGAATCAG -> TTAAGTGTCGAGAATCAGT
ATTAATATCGCCGACCAAC -> TTAATATCGCCGACCAACC
ATTACGCGGGGGATAAAAA -> TTACGCGGGGGATAAAAAC
ATTACTGACCCACCAGGTG -> TTACTGACCCACCAGGTGG
ATTAGGGCCTATGGCCTTG -> TTAGGGCCTATGGCCTTGC
ATTATCGAAGGGCAGGACG -> TTATCGAAGGGCAGGACGA
ATTATGCAAGCTAGGTAGA -> TTATGCAAGCTAGGTAGAC
ATTCACCATTTAGGAATTC -> TTCACCATTTAGGAATTCG
ATTCCCCCGTTGGCAATTC -> TTCCCCCGTTGGCAATTCA
ATTCGACACCCATCGGAGG -> TTCGACACCCATCGGAGGC
ATTCGTACCCAACAGTACC -> TTCGTACCCAACAGTACCA
ATTCGTGCGGTATCCGGTC -> TTCGTGCGGTATCCGGTCA
ATTCTACCGTTTGACCTCT -> TTCTACCGTTTGACCTCTG
ATTCTAGCTCGATGTATCC -> TTCTAGCTCGATGTATCCT
ATTCTTTAGGCTAGAGACG -> TTCTTTAGGCTAGAGACGC
ATTGACTCCTCAAAAATAT -> TTGACTCCTCAAAAATATC
ATTGCTGCAGTCGGTCCCC -> TTGCTGCAGTCGGTCCCCG
ATTGGTTTTGTTTACTAGA -> TTGGTTTTGTTTACTAGAA
ATTTACCACATAGCTAGAG -> TTTACCACATAGCTAGAGG
ATTTAGAGGCGCAGAGACA -> TTTAGAGGCGCAGAGACAA
ATTTAGATAAGTTCTATAT -> TTTAGATAAGTTCTATATC
ATTTAGGAATTCGACACCC -> TTTAGGAATTCGACACCCA
ATTTAGGTACTATATCGGA -> TTTAGGTACTATATCGGAG
ATTTCCGTGGTAACCGATG -> TTTCCGTGGTAACCGATGG
ATTTCCTCGGAAAACATGA -> TTTCCTCGGAAAACATGAG
ATTTCGCTCGGATCCTCGT -> TTTCGCTCGGATCCTCGTT
ATTTCTCGTTGTCTCGTCC -> TTTCTCGTTGTCTCGTCCT
ATTTTAAAGGGAACTACCC -> TTTTAAAGGGAACTACCCC
ATTTTCTTCTGGGTGGTTG -> TTTTCTTCTGGGTGGTTGT
ATTTTTCTCGCAAGCCTGA -> TTTTTCTCGCAAGCCTGAC
ATTTTTTGCAGCTTCTGTT -> TTTTTTGCAGCTTCTGTTT
ATTTTTTGGGCCGGCCCAG -> TTTTTTGGGCCGGCCCAGT
CAAAAATATCTCTGTTCCC -> AAAAATATCTCTGTTCCCG
CAAACTGCTATATCATCCA -> AAACTGCTATATCATCCAA
CAAAGACCACCTATAACAC -> AAAGACCACCTATAACACA
CAAAGGCCTCACAAACTGC -> AAAGGCCTCACAAACTGCT
CAAAGTTGTGATTAATATC -> AAAGTTGTGATTAATATCG
CAACAGGCGCACTACGGGC -> AACAGGCGCACTACGGGCG
CAACAGTACCATCTCCTTG -> AACAGTACCATCTCCTTGA
CAACAGTCCTAATCGAGCT -> AACAGTCCTAATCGAGCTA
CAACCATAATGTACGTTGA -> AACCATAATGTACGTTGAG
CAACCCGAGGGGGGGGCCG -> AACCCGAGGGGGGGGCCGT
CAACCTCTTCAATTTTTCT -> AACCTCTTCAATTTTTCTC
CAACGCAGGACATCCTGAT -> AACGCAGGACATCCTGATT
CAACGGCACTATTACGCGG -> AACGGCACTATTACGCGGG
CAACGGCTTCAAAGACCAC -> AACGGCTTCAAAGACCACC
CAACTGTCCGTGATGGAAC -> AACTGTCCGTGATGGAACG
CAACTTACGCATACCATTA -> AACTTACGCATACCATTAC
CAACTTGGGCCTGACTCGA -> AACTTGGGCCTGACTCGAG
CAAGCCTCCTCGAGACGCC -> AAGCCTCCTCGAGACGCCA
CAAGCCTGACCGGACAAAG -> AAGCCTGACCGGACAAAGG
CAAGCTAGGCAGCGGCGTC -> AAGCTAGGCAGCGGCGTCC
CAAGCTAGGTAGACCTCCC -> AAGCTAGGTAGACCTCCCG
CAAGCTGAGCGGCGCTGTC -> AAGCTGAGCGGCGCTGTCA
CAAGTACTTCTGGTGTGAT -> AAGTACTTCTGGTGTGATA
CAATCACACATATCCTGGC -> AATCACACATATCCTGGCG
CAATGACCACCATTTAGAG -> AATGACCACCATTTAGAGG
CAATTCACCATTTAGGAAT -> AATTCACCATTTAGGAATT
CAATTTCGCTCGGATCCTC -> AATTTCGCTCGGATCCTCG
CAATTTTCTTCTGGGTGGT -> AATTTTCTTCTGGGTGGTT
CAATTTTTCTCGCAAGCCT -> AATTTTTCTCGCAAGCCTG
CAATTTTTTGCAGCTTCTG -> AATTTTTTGCAGCTTCTGT
CACAAACTGCTATATCATC -> ACAAACTGCTATATCATCC
CACAAGCTAGGCAGCGGCG -> ACAAGCTAGGCAGCGGCGT
CACACACCACGAAGTGCTC -> ACACACCACGAAGTGCTCT
CACACAGGGTCCTTGTAGA -> ACACAGGGTCCTTGTAGAT
CACACATATCCTGGCGGAG -> ACACATATCCTGGCGGAGT
CACACCACGAAGTGCTCTT -> ACACCACGAAGTGCTCTTT
CACACGATTATGCAAGCTA -> ACACGATTATGCAAGCTAG
CACACGGTCCGCTGCCCGG -> ACACGGTCCGCTGCCCGGC
CACACTAAGCGTGTTTAGT -> ACACTAAGCGTGTTTAGTC
CACAGGCATCGGACAGCCG -> ACAGGCATCGGACAGCCGT
CACAGGGTCCTTGTAGATT -> ACAGGGTCCTTGTAGATTA
CACAGTTCGTCGGATTAAG -> ACAGTTCGTCGGATTAAGT
CACATACATGAAACCTATA -> ACATACATGAAACCTATAT
CACATAGCTAGAGGGGGCA -> ACATAGCTAGAGGGGGCAG
CACATATCCTGGCGGAGTT -> ACATATCCTGGCGGAGTTT
CACCACGAAGTGCTCTTTC -> ACCACGAAGTGCTCTTTCT
CACCAGGTGGTAGAATCTG -> ACCAGGTGGTAGAATCTGA
CACCATTTAGAGGCGCAGA -> ACCATTTAGAGGCGCAGAG
CACCATTTAGGAATTCGAC -> ACCATTTAGGAATTCGACA
CACCCATCGGAGGCCTATT -> ACCCATCGGAGGCCTATTT
CACCTATAACACATACATG -> ACCTATAACACATACATGA
CACGAAGTGCTCTTTCTTC -> ACGAAGTGCTCTTTCTTCT
CACGAGCGGGGGGGCGAAT -> ACGAGCGGGGGGGCGAATT
CACGATTATGCAAGCTAGG -> ACGATTATGCAAGCTAGGT
CACGCGAGTGCTCTAATGA -> ACGCGAGTGCTCTAATGAC
CACGGCAGTTCAACAGGCG -> ACGGCAGTTCAACAGGCGC
CACGGGAAGGTTATGCATT -> ACGGGAAGGTTATGCATTT
CACGGTCCGCTGCCCGGCT -> ACGGTCCGCTGCCCGGCTA
CACGTCACGCGAGTGCTCT -> ACGTCACGCGAGTGCTCTA
CACTAAGCGTGTTTAGTCT -> ACTAAGCGTGTTTAGTCTC
CACTACGGGCGTCGTTTTT -> ACTACGGGCGTCGTTTTTC
CACTATTACGCGGGGGATA -> ACTATTACGCGGGGGATAA
CACTCCTCAGTGTCGGACA -> ACTCCTCAGTGTCGGACAC
CACTCGTCCAGTCCTTGTC -> ACTCGTCCAGTCCTTGTCA
CACTTAGAGACCCATAGGT -> ACTTAGAGACCCATAGGTC
CAGAAAGGGACCCCGCGAT -> AGAAAGGGACCCCGCGATG
CAGACACACAGGGTCCTTG -> AGACACACAGGGTCCTTGT
CAGAGACAATTTCGCTCGG -> AGAGACAATTTCGCTCGGA
CAGAGCCTAGCTGTCGTGC -> AGAGCCTAGCTGTCGTGCC
CAGCCGCGGTTGGGCTGTA -> AGCCGCGGTTGGGCTGTAT
CAGCCGTTTGTAGAGCTGG -> AGCCGTTTGTAGAGCTGGG
CAGCGCGCACGAGCGGGGG -> AGCGCGCACGAGCGGGGGG
CAGCGGCGTCCAATCACAC -> AGCGGCGTCCAATCACACA
CAGCTTAGTTCAGCGCGCA -> AGCTTAGTTCAGCGCGCAC
CAGCTTCTGTTTTTGCAAT -> AGCTTCTGTTTTTGCAATG
CAGGACATCCTGATTTAGG -> AGGACATCCTGATTTAGGT
CAGGACGAGACATCACACG -> AGGACGAGACATCACACGA
CAGGCATCGGACAGCCGTT -> AGGCATCGGACAGCCGTTT
CAGGCCGGCTATATCGGAG -> AGGCCGGCTATATCGGAGC
CAGGCGCACTACGGGCGTC -> AGGCGCACTACGGGCGTCG
CAGGGTCCTTGTAGATTAG -> AGGGTCCTTGTAGATTAGG
CAGGGTGCCCCCGACGGTT -> AGGGTGCCCCCGACGGTTC
CAGGTGGTAGAATCTGAAA -> AGGTGGTAGAATCTGAAAC
CAGTAATTCGTACCCAACA -> AGTAATTCGTACCCAACAG
CAGTACCATCTCCTTGAGC -> AGTACCATCTCCTTGAGCC
CAGTAGGAAGCAGCTTAGT -> AGTAGGAAGCAGCTTAGTT
CAGTCCGCATCTCCTGTCC -> AGTCCGCATCTCCTGTCCC
CAGTCCTAATCGAGCTACC -> AGTCCTAATCGAGCTACCA
CAGTCCTTGTCACAGTTCG -> AGTCCTTGTCACAGTTCGT
CAGTCGGTCCCCGTCCCCT -> AGTCGGTCCCCGTCCCCTT
CAGTCTACCCAGTGATCCT -> AGTCTACCCAGTGATCCTT
CAGTGATCCTTATCAGACA -> AGTGATCCTTATCAGACAC
CAGTGTCGGACACAAGCTA -> AGTGTCGGACACAAGCTAG
CAGTGTTATAGGGACGGTC -> AGTGTTATAGGGACGGTCC
CAGTTCAACAGGCGCACTA -> AGTTCAACAGGCGCACTAC
CAGTTCGTCGGATTAAGTC -> AGTTCGTCGGATTAAGTCG
CAGTTTCCAGTAATTCGTA -> AGTTTCCAGTAATTCGTAC
CATAAGTGGCCGGACGTAA -> ATAAGTGGCCGGACGTAAA
CATAATGTACGTTGAGGGA -> ATAATGTACGTTGAGGGAC
CATAATGTCTCGCTTTACG -> ATAATGTCTCGCTTTACGC
CATAATTTTTTGGGCCGGC -> ATAATTTTTTGGGCCGGCC
CATACATGAAACCTATATC -> ATACATGAAACCTATATCG
CATACCATTACTGACCCAC -> ATACCATTACTGACCCACC
CATAGAAGGTAAAGCCGTC -> ATAGAAGGTAAAGCCGTCT
CATAGCTAGAGGGGGCAGG -> ATAGCTAGAGGGGGCAGGG
CATAGGTCGTTCTCTGTCG -> ATAGGTCGTTCTCTGTCGC
CATATCACTCCTCAGTGTC -> ATATCACTCCTCAGTGTCG
CATATCCTGGCGGAGTTTT -> ATATCCTGGCGGAGTTTTG
CATATGGGGCAACGGCTTC -> ATATGGGGCAACGGCTTCA
CATCACACGATTATGCAAG -> ATCACACGATTATGCAAGC
CATCATTCTAGCTCGATGT -> ATCATTCTAGCTCGATGTA
CATCCAACAGTCCTAATCG -> ATCCAACAGTCCTAATCGA
CATCCTGATTTAGGTACTA -> ATCCTGATTTAGGTACTAT
CATCGGACAGCCGTTTGTA -> ATCGGACAGCCGTTTGTAG
CATCGGAGGCCTATTTAGA -> ATCGGAGGCCTATTTAGAT
CATCTCCTGTCCCTAGGCT -> ATCTCCTGTCCCTAGGCTG
CATCTCCTTGAGCCTATAT -> ATCTCCTTGAGCCTATATG
CATGAAACCTATATCGGAG -> ATGAAACCTATATCGGAGC
CATGAGTTATCATTTTAAA -> ATGAGTTATCATTTTAAAG
CATGCACTTAGAGACCCAT -> ATGCACTTAGAGACCCATA
CATGTACTATCGTCCCAAG -> ATGTACTATCGTCCCAAGC
CATGTCCAGTGTTATAGGG -> ATGTCCAGTGTTATAGGGA
CATTACTGACCCACCAGGT -> ATTACTGACCCACCAGGTG
CATTATCGAAGGGCAGGAC -> ATTATCGAAGGGCAGGACG
CATTCGTGCGGTATCCGGT -> ATTCGTGCGGTATCCGGTC
CATTCTAGCTCGATGTATC -> ATTCTAGCTCGATGTATCC
CATTCTTTAGGCTAGAGAC -> ATTCTTTAGGCTAGAGACG
CATTGACTCCTCAAAAATA -> ATTGACTCCTCAAAAATAT
CATTGCTGCAGTCGGTCCC -> ATTGCTGCAGTCGGTCCCC
CATTTACCACATAGCTAGA -> ATTTACCACATAGCTAGAG
CATTTAGAGGCGCAGAGAC -> ATTTAGAGGCGCAGAGACA
CATTTAGGAATTCGACACC -> ATTTAGGAATTCGACACCC
CATTTTAAAGGGAACTACC -> ATTTTAAAGGGAACTACCC
CCAACAGTACCATCTCCTT -> CAACAGTACCATCTCCTTG
CCAACAGTCCTAATCGAGC -> CAACAGTCCTAATCGAGCT
CCAACCATAATGTACGTTG -> CAACCATAATGTACGTTGA
CCAACGCAGGACATCCTGA -> CAACGCAGGACATCCTGAT
CCAACGGCACTATTACGCG -> CAACGGCACTATTACGCGG
CCAAGCTGAGCGGCGCTGT -> CAAGCTGAGCGGCGCTGTC
CCAATCACACATATCCTGG -> CAATCACACATATCCTGGC
CCACACGGTCCGCTGCCCG -> CACACGGTCCGCTGCCCGG
CCACATAGCTAGAGGGGGC -> CACATAGCTAGAGGGGGCA
CCACCAGGTGGTAGAATCT -> CACCAGGTGGTAGAATCTG
CCACCATTTAGAGGCGCAG -> CACCATTTAGAGGCGCAGA
CCACCTATAACACATACAT -> CACCTATAACACATACATG
CCACGAAGTGCTCTTTCTT -> CACGAAGTGCTCTTTCTTC
CCACGGCAGTTCAACAGGC -> CACGGCAGTTCAACAGGCG
CCAGGTGGTAGAATCTGAA -> CAGGTGGTAGAATCTGAAA
CCAGTAATTCGTACCCAAC -> CAGTAATTCGTACCCAACA
CCAGTCCGCATCTCCTGTC -> CAGTCCGCATCTCCTGTCC
CCAGTCCTTGTCACAGTTC -> CAGTCCTTGTCACAGTTCG
CCAGTGATCCTTATCAGAC -> CAGTGATCCTTATCAGACA
CCAGTGTTATAGGGACGGT -> CAGTGTTATAGGGACGGTC
CCAGTTTCCAGTAATTCGT -> CAGTTTCCAGTAATTCGTA
CCATAAGTGGCCGGACGTA -> CATAAGTGGCCGGACGTAA
CCATAATGTACGTTGAGGG -> CATAATGTACGTTGAGGGA
CCATAGGTCGTTCTCTGTC -> CATAGGTCGTTCTCTGTCG
CCATATCACTCCTCAGTGT -> CATATCACTCCTCAGTGTC
CCATCGGAGGCCTATTTAG -> CATCGGAGGCCTATTTAGA
CCATCTCCTTGAGCCTATA -> CATCTCCTTGAGCCTATAT
CCATGCACTTAGAGACCCA -> CATGCACTTAGAGACCCAT
CCATTACTGACCCACCAGG -> CATTACTGACCCACCAGGT
CCATTGCTGCAGTCGGTCC -> CATTGCTGCAGTCGGTCCC
CCATTTAGAGGCGCAGAGA -> CATTTAGAGGCGCAGAGAC
CCATTTAGGAATTCGACAC -> CATTTAGGAATTCGACACC
CCCAACAGTACCATCTCCT -> CCAACAGTACCATCTCCTT
CCCAAGCTGAGCGGCGCTG -> CCAAGCTGAGCGGCGCTGT
CCCACCAGGTGGTAGAATC -> CCACCAGGTGGTAGAATCT
CCCAGTCCGCATCTCCTGT -> CCAGTCCGCATCTCCTGTC
CCCAGTGATCCTTATCAGA -> CCAGTGATCCTTATCAGAC
CCCATAGGTCGTTCTCTGT -> CCATAGGTCGTTCTCTGTC
CCCATCGGAGGCCTATTTA -> CCATCGGAGGCCTATTTAG
CCCATGCACTTAGAGACCC -> CCATGCACTTAGAGACCCA
CCCCCGACGGTTCGCGCTC -> CCCCGACGGTTCGCGCTCA
CCCCCGTTGGCAATTCACC -> CCCCGTTGGCAATTCACCA
CCCCGACGGTTCGCGCTCA -> CCCGACGGTTCGCGCTCAG
CCCCGCGATGGGCAACTTA -> CCCGCGATGGGCAACTTAC
CCCCGTCCCCTTCCTGTCA -> CCCGTCCCCTTCCTGTCAC
CCCCGTTGGCAATTCACCA -> CCCGTTGGCAATTCACCAT
CCCCTAAGACTACTACGGA -> CCCTAAGACTACTACGGAG
CCCCTGTTTTCTGAACCTG -> CCCTGTTTTCTGAACCTGC
CCCCTTCCTGTCACGTCAC -> CCCTTCCTGTCACGTCACG
CCCGACGGTTCGCGCTCAG -> CCGACGGTTCGCGCTCAGT
CCCGAGGGGGGGGCCGTAG -> CCGAGGGGGGGGCCGTAGG
CCCGATACGCATATGGGGC -> CCGATACGCATATGGGGCA
CCCGCCTATCGTTTTTAGC -> CCGCCTATCGTTTTTAGCA
CCCGCGATGGGCAACTTAC -> CCGCGATGGGCAACTTACG
CCCGCGTTGCTAGAGCTAT -> CCGCGTTGCTAGAGCTATT
CCCGGCTAAACGCCCGCCT -> CCGGCTAAACGCCCGCCTA
CCCGTAGATGTTTCATAAT -> CCGTAGATGTTTCATAATT
CCCGTCCCCTTCCTGTCAC -> CCGTCCCCTTCCTGTCACG
CCCGTTGGCAATTCACCAT -> CCGTTGGCAATTCACCATT
CCCTAAGACTACTACGGAG -> CCTAAGACTACTACGGAGT
CCCTAGGCTGTATGCTGTA -> CCTAGGCTGTATGCTGTAC
CCCTATGGGTTTATGGCCC -> CCTATGGGTTTATGGCCCT
CCCTGGCCACACGGTCCGC -> CCTGGCCACACGGTCCGCT
CCCTGTTTTCTGAACCTGC -> CCTGTTTTCTGAACCTGCA
CCCTTCCTGTCACGTCACG -> CCTTCCTGTCACGTCACGC
CCCTTTGCTCCCCTAAGAC -> CCTTTGCTCCCCTAAGACT
CCGACCAACCATAATGTAC -> CGACCAACCATAATGTACG
CCGACGGTTCGCGCTCAGT -> CGACGGTTCGCGCTCAGTA
CCGAGCAACCCGAGGGGGG -> CGAGCAACCCGAGGGGGGG
CCGAGGGGGGGGCCGTAGG -> CGAGGGGGGGGCCGTAGGT
CCGATACGCATATGGGGCA -> CGATACGCATATGGGGCAA
CCGATGGATAACGCATTGA -> CGATGGATAACGCATTGAC
CCGCATCTCCTGTCCCTAG -> CGCATCTCCTGTCCCTAGG
CCGCCTATCGTTTTTAGCA -> CGCCTATCGTTTTTAGCAA
CCGCGATGGGCAACTTACG -> CGCGATGGGCAACTTACGC
CCGCGGTTGGGCTGTATCG -> CGCGGTTGGGCTGTATCGA
CCGCGTTGCTAGAGCTATT -> CGCGTTGCTAGAGCTATTC
CCGCTGCCCGGCTAAACGC -> CGCTGCCCGGCTAAACGCC
CCGGACAAAGGCCTCACAA -> CGGACAAAGGCCTCACAAA
CCGGACGTAAAAATCAACT -> CGGACGTAAAAATCAACTT
CCGGATCGTAACCATAAGT -> CGGATCGTAACCATAAGTG
CCGGCCCAGTCCGCATCTC -> CGGCCCAGTCCGCATCTCC
CCGGCTAAACGCCCGCCTA -> CGGCTAAACGCCCGCCTAT
CCGGCTATATCGGAGCGAT -> CGGCTATATCGGAGCGATC
CCGGCTATCATGTACTATC -> CGGCTATCATGTACTATCG
CCGGTCACAGGCATCGGAC -> CGGTCACAGGCATCGGACA
CCGTAGATGTTTCATAATT -> CGTAGATGTTTCATAATTT
CCGTAGGTTCGTAGGCAAC -> CGTAGGTTCGTAGGCAACT
CCGTCCCCTTCCTGTCACG -> CGTCCCCTTCCTGTCACGT
CCGTCCCGATACGCATATG -> CGTCCCGATACGCATATGG
CCGTCTAGAATCAGAGCCT -> CGTCTAGAATCAGAGCCTA
CCGTGATGGAACGCGTGGA -> CGTGATGGAACGCGTGGAT
CCGTGGTAACCGATGGATA -> CGTGGTAACCGATGGATAA
CCGTTGGCAATTCACCATT -> CGTTGGCAATTCACCATTT
CCGTTTGACCTCTGCGTCG -> CGTTTGACCTCTGCGTCGT
CCGTTTGTAGAGCTGGGCA -> CGTTTGTAGAGCTGGGCAC
CCTAAGACTACTACGGAGT -> CTAAGACTACTACGGAGTT
CCTAATCGAGCTACCAACG -> CTAATCGAGCTACCAACGC
CCTAGCTGTCGTGCCATAT -> CTAGCTGTCGTGCCATATC
CCTAGGCTGTATGCTGTAC -> CTAGGCTGTATGCTGTACC
CCTAGTTCAATTTTCTTCT -> CTAGTTCAATTTTCTTCTG
CCTATAACACATACATGAA -> CTATAACACATACATGAAA
CCTATATCGGAGCGATCCT -> CTATATCGGAGCGATCCTC
CCTATATGGATCCGTCCCG -> CTATATGGATCCGTCCCGA
CCTATCGTTTTTAGCAAGT -> CTATCGTTTTTAGCAAGTA
CCTATGGCCTTGCTTCTGG -> CTATGGCCTTGCTTCTGGA
CCTATGGGTTTATGGCCCT -> CTATGGGTTTATGGCCCTT
CCTATTTAGATAAGTTCTA -> CTATTTAGATAAGTTCTAT
CCTCAAAAATATCTCTGTT -> CTCAAAAATATCTCTGTTC
CCTCACAAACTGCTATATC -> CTCACAAACTGCTATATCA
CCTCACACTAAGCGTGTTT -> CTCACACTAAGCGTGTTTA
CCTCAGTGTCGGACACAAG -> CTCAGTGTCGGACACAAGC
CCTCCCGTAGATGTTTCAT -> CTCCCGTAGATGTTTCATA
CCTCCTCGAGACGCCATTG -> CTCCTCGAGACGCCATTGC
CCTCGAACGAGTCAGGCCG -> CTCGAACGAGTCAGGCCGG
CCTCGAGACGCCATTGCTG -> CTCGAGACGCCATTGCTGC
CCTCGGAAAACATGAGTTA -> CTCGGAAAACATGAGTTAT
CCTCGTTAATCAAGCCTCC -> CTCGTTAATCAAGCCTCCT
CCTCTACCCTATGGGTTTA -> CTCTACCCTATGGGTTTAT
CCTCTCTACATTATCGAAG -> CTCTCTACATTATCGAAGG
CCTCTGCGTCGTCTAGCCA -> CTCTGCGTCGTCTAGCCAG
CCTCTTCAATTTTTCTCGC -> CTCTTCAATTTTTCTCGCA
CCTCTTCGAGAGCGCTTCT -> CTCTTCGAGAGCGCTTCTG
CCTGACCGGACAAAGGCCT -> CTGACCGGACAAAGGCCTC
CCTGACTCGAGCTTCTGGT -> CTGACTCGAGCTTCTGGTT
CCTGATTTAGGTACTATAT -> CTGATTTAGGTACTATATC
CCTGCATCATTCTAGCTCG -> CTGCATCATTCTAGCTCGA
CCTGCTCGGAGGGTCTTCT -> CTGCTCGGAGGGTCTTCTG
CCTGGCCACACGGTCCGCT -> CTGGCCACACGGTCCGCTG
CCTGGCGGAGTTTTGCCGG -> CTGGCGGAGTTTTGCCGGC
CCTGTCACGTCACGCGAGT -> CTGTCACGTCACGCGAGTG
CCTGTCCCTAGGCTGTATG -> CTGTCCCTAGGCTGTATGC
CCTGTCCGAGCAACCCGAG -> CTGTCCGAGCAACCCGAGG
CCTGTTTTCTGAACCTGCA -> CTGTTTTCTGAACCTGCAT
CCTTATCAGACACACAGGG -> CTTATCAGACACACAGGGT
CCTTCCTGTCACGTCACGC -> CTTCCTGTCACGTCACGCG
CCTTGAGCCTATATGGATC -> CTTGAGCCTATATGGATCC
CCTTGCTTCTGGAATCATT -> CTTGCTTCTGGAATCATTC
CCTTGGATCGACGTCTTCT -> CTTGGATCGACGTCTTCTG
CCTTGTAGATTAGGGCCTA -> CTTGTAGATTAGGGCCTAT
CCTTGTCACAGTTCGTCGG -> CTTGTCACAGTTCGTCGGA
CCTTTAGAGATAGGCATTC -> CTTTAGAGATAGGCATTCG
CCTTTGCTCCCCTAAGACT -> CTTTGCTCCCCTAAGACTA
CGAACGAGTCAGGCCGGCT -> GAACGAGTCAGGCCGGCTA
CGAAGGGCAGGACGAGACA -> GAAGGGCAGGACGAGACAT
CGAAGTGCTCTTTCTTCTC -> GAAGTGCTCTTTCTTCTCT
CGAATGTTTGCAGAAAGGG -> GAATGTTTGCAGAAAGGGA
CGAATTCCCCCGTTGGCAA -> GAATTCCCCCGTTGGCAAT
CGACACCCATCGGAGGCCT -> GACACCCATCGGAGGCCTA
CGACCAACCATAATGTACG -> GACCAACCATAATGTACGT
CGACGGTTCGCGCTCAGTA -> GACGGTTCGCGCTCAGTAG
CGACGTCTTCTGGGTGGTT -> GACGTCTTCTGGGTGGTTG
CGAGAATCAGTCTACCCAG -> GAGAATCAGTCTACCCAGT
CGAGACATCACACGATTAT -> GAGACATCACACGATTATG
CGAGACGCCATTGCTGCAG -> GAGACGCCATTGCTGCAGT
CGAGAGCGCTTCTGGGTGG -> GAGAGCGCTTCTGGGTGGT
CGAGCAACCCGAGGGGGGG -> GAGCAACCCGAGGGGGGGG
CGAGCGGGGGGGCGAATTC -> GAGCGGGGGGGCGAATTCC
CGAGCTACCAACGCAGGAC -> GAGCTACCAACGCAGGACA
CGAGCTTCTGGTTAGAGAC -> GAGCTTCTGGTTAGAGACT
CGAGGATGTCGCGGAATTT -> GAGGATGTCGCGGAATTTC
CGAGGGGGGGGCCGTAGGT -> GAGGGGGGGGCCGTAGGTT
CGAGTCAGGCCGGCTATAT -> GAGTCAGGCCGGCTATATC
CGAGTGCTCTAATGACATA -> GAGTGCTCTAATGACATAA
CGATACGCATATGGGGCAA -> GATACGCATATGGGGCAAC
CGATCCTAGTTCAATTTTC -> GATCCTAGTTCAATTTTCT
CGATCCTCTTCGAGAGCGC -> GATCCTCTTCGAGAGCGCT
CGATCCTGCTCGGAGGGTC -> GATCCTGCTCGGAGGGTCT
CGATCCTTGGATCGACGTC -> GATCCTTGGATCGACGTCT
CGATGGATAACGCATTGAC -> GATGGATAACGCATTGACT
CGATGGGCAACTTACGCAT -> GATGGGCAACTTACGCATA
CGATGTATCCTGTCCGAGC -> GATGTATCCTGTCCGAGCA
CGATTATGCAAGCTAGGTA -> GATTATGCAAGCTAGGTAG
CGATTGGTTTTGTTTACTA -> GATTGGTTTTGTTTACTAG
CGCAAGCCTGACCGGACAA -> GCAAGCCTGACCGGACAAA
CGCACGAGCGGGGGGGCGA -> GCACGAGCGGGGGGGCGAA
CGCACTACGGGCGTCGTTT -> GCACTACGGGCGTCGTTTT
CGCACTCGTCCAGTCCTTG -> GCACTCGTCCAGTCCTTGT
CGCAGAGACAATTTCGCTC -> GCAGAGACAATTTCGCTCG
CGCAGGACATCCTGATTTA -> GCAGGACATCCTGATTTAG
CGCATACCATTACTGACCC -> GCATACCATTACTGACCCA
CGCATATGGGGCAACGGCT -> GCATATGGGGCAACGGCTT
CGCATCTCCTGTCCCTAGG -> GCATCTCCTGTCCCTAGGC
CGCATTGACTCCTCAAAAA -> GCATTGACTCCTCAAAAAT
CGCCATTGCTGCAGTCGGT -> GCCATTGCTGCAGTCGGTC
CGCCCGCCTATCGTTTTTA -> GCCCGCCTATCGTTTTTAG
CGCCGACCAACCATAATGT -> GCCGACCAACCATAATGTA
CGCCTATCGTTTTTAGCAA -> GCCTATCGTTTTTAGCAAG
CGCCTTTAGAGATAGGCAT -> GCCTTTAGAGATAGGCATT
CGCGAGTGCTCTAATGACA -> GCGAGTGCTCTAATGACAT
CGCGATGGGCAACTTACGC -> GCGATGGGCAACTTACGCA
CGCGCACGAGCGGGGGGGC -> GCGCACGAGCGGGGGGGCG
CGCGCTCAGTAGGAAGCAG -> GCGCTCAGTAGGAAGCAGC
CGCGGAATTTCCTCGGAAA -> GCGGAATTTCCTCGGAAAA
CGCGGGGGATAAAAACCCA -> GCGGGGGATAAAAACCCAT
CGCGGTTGGGCTGTATCGA -> GCGGTTGGGCTGTATCGAG
CGCGTGGATCATGTCCAGT -> GCGTGGATCATGTCCAGTG
CGCGTTGCTAGAGCTATTC -> GCGTTGCTAGAGCTATTCT
CGCTAGGAACAACCTCTTC -> GCTAGGAACAACCTCTTCA
CGCTATCGCTAGGAACAAC -> GCTATCGCTAGGAACAACC
CGCTCAGTAGGAAGCAGCT -> GCTCAGTAGGAAGCAGCTT
CGCTCGGATCCTCGTTAAT -> GCTCGGATCCTCGTTAATC
CGCTGCCCGGCTAAACGCC -> GCTGCCCGGCTAAACGCCC
CGCTGTCAAAGTTGTGATT -> GCTGTCAAAGTTGTGATTA
CGCTTCTGGGTGGTTGTGT -> GCTTCTGGGTGGTTGTGTT
CGCTTTACGCACTCGTCCA -> GCTTTACGCACTCGTCCAG
CGGAAAACATGAGTTATCA -> GGAAAACATGAGTTATCAT
CGGAATTTCCTCGGAAAAC -> GGAATTTCCTCGGAAAACA
CGGACAAAGGCCTCACAAA -> GGACAAAGGCCTCACAAAC
CGGACACAAGCTAGGCAGC -> GGACACAAGCTAGGCAGCG
CGGACAGCCGTTTGTAGAG -> GGACAGCCGTTTGTAGAGC
CGGACGTAAAAATCAACTT -> GGACGTAAAAATCAACTTG
CGGAGCGATCCTAGTTCAA -> GGAGCGATCCTAGTTCAAT
CGGAGCGATCCTCTTCGAG -> GGAGCGATCCTCTTCGAGA
CGGAGCGATCCTGCTCGGA -> GGAGCGATCCTGCTCGGAG
CGGAGCGATCCTTGGATCG -> GGAGCGATCCTTGGATCGA
CGGAGGCCTATTTAGATAA -> GGAGGCCTATTTAGATAAG
CGGAGGGTCTTCTGGGTGG -> GGAGGGTCTTCTGGGTGGT
CGGAGTTTCAGCCGCGGTT -> GGAGTTTCAGCCGCGGTTG
CGGAGTTTTGCCGGCTATC -> GGAGTTTTGCCGGCTATCA
CGGATCCTCGTTAATCAAG -> GGATCCTCGTTAATCAAGC
CGGATCGTAACCATAAGTG -> GGATCGTAACCATAAGTGG
CGGATTAAGTCGCAGCGAA -> GGATTAAGTCGCAGCGAAG
CGGCACTATTACGCGGGGG -> GGCACTATTACGCGGGGGA
CGGCAGTTCAACAGGCGCA -> GGCAGTTCAACAGGCGCAC
CGGCCCAGTCCGCATCTCC -> GGCCCAGTCCGCATCTCCT
CGGCGCTGTCAAAGTTGTG -> GGCGCTGTCAAAGTTGTGA
CGGCGTCCAATCACACATA -> GGCGTCCAATCACACATAT
CGGCTAAACGCCCGCCTAT -> GGCTAAACGCCCGCCTATC
CGGCTATATCGGAGCGATC -> GGCTATATCGGAGCGATCC
CGGCTATCATGTACTATCG -> GGCTATCATGTACTATCGT
CGGCTTCAAAGACCACCTA -> GGCTTCAAAGACCACCTAT
CGGGAAGGTTATGCATTTA -> GGGAAGGTTATGCATTTAC
CGGGCGTCGTTTTTCCAAC -> GGGCGTCGTTTTTCCAACG
CGGGGGATAAAAACCCATG -> GGGGGATAAAAACCCATGC
CGGGGGGGCGAATTCCCCC -> GGGGGGGCGAATTCCCCCG
CGGTATCCGGTCACAGGCA -> GGTATCCGGTCACAGGCAT
CGGTCACAGGCATCGGACA -> GGTCACAGGCATCGGACAG
CGGTCCCCGTCCCCTTCCT -> GGTCCCCGTCCCCTTCCTG
CGGTCCGCTGCCCGGCTAA -> GGTCCGCTGCCCGGCTAAA
CGGTCCTCACACTAAGCGT -> GGTCCTCACACTAAGCGTG
CGGTTCGCGCTCAGTAGGA -> GGTTCGCGCTCAGTAGGAA
CGGTTGGGCTGTATCGAGG -> GGTTGGGCTGTATCGAGGA
CGTAAAAATCAACTTGGGC -> GTAAAAATCAACTTGGGCC
CGTAACCATAAGTGGCCGG -> GTAACCATAAGTGGCCGGA
CGTACCCAACAGTACCATC -> GTACCCAACAGTACCATCT
CGTAGATGTTTCATAATTT -> GTAGATGTTTCATAATTTT
CGTAGGCAACTGTCCGTGA -> GTAGGCAACTGTCCGTGAT
CGTAGGTTCGTAGGCAACT -> GTAGGTTCGTAGGCAACTG
CGTCACGCGAGTGCTCTAA -> GTCACGCGAGTGCTCTAAT
CGTCCAATCACACATATCC -> GTCCAATCACACATATCCT
CGTCCAGTCCTTGTCACAG -> GTCCAGTCCTTGTCACAGT
CGTCCCAAGCTGAGCGGCG -> GTCCCAAGCTGAGCGGCGC
CGTCCCCTTCCTGTCACGT -> GTCCCCTTCCTGTCACGTC
CGTCCCGATACGCATATGG -> GTCCCGATACGCATATGGG
CGTCCTCGAACGAGTCAGG -> GTCCTCGAACGAGTCAGGC
CGTCGGATTAAGTCGCAGC -> GTCGGATTAAGTCGCAGCG
CGTCGTCTAGCCAGTTTCC -> GTCGTCTAGCCAGTTTCCA
CGTCGTTTTTCCAACGGCA -> GTCGTTTTTCCAACGGCAC
CGTCTAGAATCAGAGCCTA -> GTCTAGAATCAGAGCCTAG
CGTCTAGCCAGTTTCCAGT -> GTCTAGCCAGTTTCCAGTA
CGTCTTCTGGGTGGTTGTG -> GTCTTCTGGGTGGTTGTGT
CGTGATGGAACGCGTGGAT -> GTGATGGAACGCGTGGATC
CGTGCCATATCACTCCTCA -> GTGCCATATCACTCCTCAG
CGTGCGGTATCCGGTCACA -> GTGCGGTATCCGGTCACAG
CGTGGATCATGTCCAGTGT -> GTGGATCATGTCCAGTGTT
CGTGGTAACCGATGGATAA -> GTGGTAACCGATGGATAAC
CGTGTTTAGTCTCTCCGGA -> GTGTTTAGTCTCTCCGGAT
CGTTAATCAAGCCTCCTCG -> GTTAATCAAGCCTCCTCGA
CGTTCTCTGTCGCCTTTAG -> GTTCTCTGTCGCCTTTAGA
CGTTGAGGGACTTTTATTT -> GTTGAGGGACTTTTATTTC
CGTTGCTAGAGCTATTCTA -> GTTGCTAGAGCTATTCTAC
CGTTGGCAATTCACCATTT -> GTTGGCAATTCACCATTTA
CGTTGTCTCGTCCTCGAAC -> GTTGTCTCGTCCTCGAACG
CGTTTGACCTCTGCGTCGT -> GTTTGACCTCTGCGTCGTC
CGTTTGTAGAGCTGGGCAC -> GTTTGTAGAGCTGGGCACG
CGTTTTTAGCAAGTACTTC -> GTTTTTAGCAAGTACTTCT
CGTTTTTCCAACGGCACTA -> GTTTTTCCAACGGCACTAT
CTAAACGCCCGCCTATCGT -> TAAACGCCCGCCTATCGTT
CTAAGACTACTACGGAGTT -> TAAGACTACTACGGAGTTT
CTAAGCGTGTTTAGTCTCT -> TAAGCGTGTTTAGTCTCTC
CTAATCGAGCTACCAACGC -> TAATCGAGCTACCAACGCA
CTAATGACATAATGTCTCG -> TAATGACATAATGTCTCGC
CTACACACACCACGAAGTG -> TACACACACCACGAAGTGC
CTACATTATCGAAGGGCAG -> TACATTATCGAAGGGCAGG
CTACCAACGCAGGACATCC -> TACCAACGCAGGACATCCT
CTACCCAGTGATCCTTATC -> TACCCAGTGATCCTTATCA
CTACCCCTGTTTTCTGAAC -> TACCCCTGTTTTCTGAACC
CTACCCTATGGGTTTATGG -> TACCCTATGGGTTTATGGC
CTACCGTTTGACCTCTGCG -> TACCGTTTGACCTCTGCGT
CTACGGAGTTTCAGCCGCG -> TACGGAGTTTCAGCCGCGG
CTACGGGCGTCGTTTTTCC -> TACGGGCGTCGTTTTTCCA
CTACTACGGAGTTTCAGCC -> TACTACGGAGTTTCAGCCG
CTAGAAGCGAATGTTTGCA -> TAGAAGCGAATGTTTGCAG
CTAGAATCAGAGCCTAGCT -> TAGAATCAGAGCCTAGCTG
CTAGAGACGCTATCGCTAG -> TAGAGACGCTATCGCTAGG
CTAGAGCTATTCTACCGTT -> TAGAGCTATTCTACCGTTT
CTAGAGGGGGCAGGGTGCC -> TAGAGGGGGCAGGGTGCCC
CTAGCCAGTTTCCAGTAAT -> TAGCCAGTTTCCAGTAATT
CTAGCTCGATGTATCCTGT -> TAGCTCGATGTATCCTGTC
CTAGCTGTCGTGCCATATC -> TAGCTGTCGTGCCATATCA
CTAGGAACAACCTCTTCAA -> TAGGAACAACCTCTTCAAT
CTAGGCAGCGGCGTCCAAT -> TAGGCAGCGGCGTCCAATC
CTAGGCTGTATGCTGTACC -> TAGGCTGTATGCTGTACCT
CTAGGTAGACCTCCCGTAG -> TAGGTAGACCTCCCGTAGA
CTAGTTCAATTTTCTTCTG -> TAGTTCAATTTTCTTCTGG
CTATAACACATACATGAAA -> TATAACACATACATGAAAC
CTATATCATCCAACAGTCC -> TATATCATCCAACAGTCCT
CTATATCGGAGCGATCCTA -> TATATCGGAGCGATCCTAG
CTATATCGGAGCGATCCTC -> TATATCGGAGCGATCCTCT
CTATATCGGAGCGATCCTG -> TATATCGGAGCGATCCTGC
CTATATCGGAGCGATCCTT -> TATATCGGAGCGATCCTTG
CTATATGGATCCGTCCCGA -> TATATGGATCCGTCCCGAT
CTATCATGTACTATCGTCC -> TATCATGTACTATCGTCCC
CTATCGCTAGGAACAACCT -> TATCGCTAGGAACAACCTC
CTATCGTCCCAAGCTGAGC -> TATCGTCCCAAGCTGAGCG
CTATCGTTTTTAGCAAGTA -> TATCGTTTTTAGCAAGTAC
CTATGGCCTTGCTTCTGGA -> TATGGCCTTGCTTCTGGAA
CTATGGGTTTATGGCCCTT -> TATGGGTTTATGGCCCTTT
CTATTACGCGGGGGATAAA -> TATTACGCGGGGGATAAAA
CTATTCTACCGTTTGACCT -> TATTCTACCGTTTGACCTC
CTATTTAGATAAGTTCTAT -> TATTTAGATAAGTTCTATA
CTCAAAAATATCTCTGTTC -> TCAAAAATATCTCTGTTCC
CTCACAAACTGCTATATCA -> TCACAAACTGCTATATCAT
CTCACACTAAGCGTGTTTA -> TCACACTAAGCGTGTTTAG
CTCAGTAGGAAGCAGCTTA -> TCAGTAGGAAGCAGCTTAG
CTCAGTGTCGGACACAAGC -> TCAGTGTCGGACACAAGCT
CTCCCCTAAGACTACTACG -> TCCCCTAAGACTACTACGG
CTCCCGTAGATGTTTCATA -> TCCCGTAGATGTTTCATAA
CTCCGGATCGTAACCATAA -> TCCGGATCGTAACCATAAG
CTCCTCAAAAATATCTCTG -> TCCTCAAAAATATCTCTGT
CTCCTCAGTGTCGGACACA -> TCCTCAGTGTCGGACACAA
CTCCTCGAGACGCCATTGC -> TCCTCGAGACGCCATTGCT
CTCCTGTCCCTAGGCTGTA -> TCCTGTCCCTAGGCTGTAT
CTCCTTGAGCCTATATGGA -> TCCTTGAGCCTATATGGAT
CTCGAACGAGTCAGGCCGG -> TCGAACGAGTCAGGCCGGC
CTCGAGACGCCATTGCTGC -> TCGAGACGCCATTGCTGCA
CTCGAGCTTCTGGTTAGAG -> TCGAGCTTCTGGTTAGAGA
CTCGATGTATCCTGTCCGA -> TCGATGTATCCTGTCCGAG
CTCGCAAGCCTGACCGGAC -> TCGCAAGCCTGACCGGACA
CTCGCTTTACGCACTCGTC -> TCGCTTTACGCACTCGTCC
CTCGGAAAACATGAGTTAT -> TCGGAAAACATGAGTTATC
CTCGGAGGGTCTTCTGGGT -> TCGGAGGGTCTTCTGGGTG
CTCGGATCCTCGTTAATCA -> TCGGATCCTCGTTAATCAA
CTCGTCCAGTCCTTGTCAC -> TCGTCCAGTCCTTGTCACA
CTCGTCCTCGAACGAGTCA -> TCGTCCTCGAACGAGTCAG
CTCGTTAATCAAGCCTCCT -> TCGTTAATCAAGCCTCCTC
CTCGTTGTCTCGTCCTCGA -> TCGTTGTCTCGTCCTCGAA
CTCTAATGACATAATGTCT -> TCTAATGACATAATGTCTC
CTCTACATTATCGAAGGGC -> TCTACATTATCGAAGGGCA
CTCTACCCTATGGGTTTAT -> TCTACCCTATGGGTTTATG
CTCTCCGGATCGTAACCAT -> TCTCCGGATCGTAACCATA
CTCTCTACATTATCGAAGG -> TCTCTACATTATCGAAGGG
CTCTCTGGATCCCTGGCCA -> TCTCTGGATCCCTGGCCAC
CTCTGCGTCGTCTAGCCAG -> TCTGCGTCGTCTAGCCAGT
CTCTGGATCCCTGGCCACA -> TCTGGATCCCTGGCCACAC
CTCTGTCGCCTTTAGAGAT -> TCTGTCGCCTTTAGAGATA
CTCTGTTCCCGCGTTGCTA -> TCTGTTCCCGCGTTGCTAG
CTCTTCAATTTTTCTCGCA -> TCTTCAATTTTTCTCGCAA
CTCTTCGAGAGCGCTTCTG -> TCTTCGAGAGCGCTTCTGG
CTCTTTCTTCTCTCTGGAT -> TCTTTCTTCTCTCTGGATC
CTGAAACTGTTGATTAAGT -> TGAAACTGTTGATTAAGTG
CTGAACCTGCATCATTCTA -> TGAACCTGCATCATTCTAG
CTGACCCACCAGGTGGTAG -> TGACCCACCAGGTGGTAGA
CTGACCGGACAAAGGCCTC -> TGACCGGACAAAGGCCTCA
CTGACTCGAGCTTCTGGTT -> TGACTCGAGCTTCTGGTTA
CTGAGCGGCGCTGTCAAAG -> TGAGCGGCGCTGTCAAAGT
CTGATTTAGGTACTATATC -> TGATTTAGGTACTATATCG
CTGCAGTCGGTCCCCGTCC -> TGCAGTCGGTCCCCGTCCC
CTGCATCATTCTAGCTCGA -> TGCATCATTCTAGCTCGAT
CTGCCCGGCTAAACGCCCG -> TGCCCGGCTAAACGCCCGC
CTGCGTCGTCTAGCCAGTT -> TGCGTCGTCTAGCCAGTTT
CTGCTATATCATCCAACAG -> TGCTATATCATCCAACAGT
CTGCTCGGAGGGTCTTCTG -> TGCTCGGAGGGTCTTCTGG
CTGGAATCATTCTTTAGGC -> TGGAATCATTCTTTAGGCT
CTGGATCCCTGGCCACACG -> TGGATCCCTGGCCACACGG
CTGGCCACACGGTCCGCTG -> TGGCCACACGGTCCGCTGC
CTGGCGGAGTTTTGCCGGC -> TGGCGGAGTTTTGCCGGCT
CTGGGCACGGGAAGGTTAT -> TGGGCACGGGAAGGTTATG
CTGGGTGGTTGTGTTGAAC -> TGGGTGGTTGTGTTGAACT
CTGGGTGGTTGTGTTGATC -> TGGGTGGTTGTGTTGATCG
CTGGGTGGTTGTGTTGCAT -> TGGGTGGTTGTGTTGCATA
CTGGGTGGTTGTGTTGTAA -> TGGGTGGTTGTGTTGTAAT
CTGGTGTGATATACTTGTC -> TGGTGTGATATACTTGTCC
CTGGTTAGAGACTTACTTC -> TGGTTAGAGACTTACTTCC
CTGTACCTCTACCCTATGG -> TGTACCTCTACCCTATGGG
CTGTATCGAGGATGTCGCG -> TGTATCGAGGATGTCGCGG
CTGTATGCTGTACCTCTAC -> TGTATGCTGTACCTCTACC
CTGTCAAAGTTGTGATTAA -> TGTCAAAGTTGTGATTAAT
CTGTCACGTCACGCGAGTG -> TGTCACGTCACGCGAGTGC
CTGTCCCTAGGCTGTATGC -> TGTCCCTAGGCTGTATGCT
CTGTCCGAGCAACCCGAGG -> TGTCCGAGCAACCCGAGGG
CTGTCCGTGATGGAACGCG -> TGTCCGTGATGGAACGCGT
CTGTCGCCTTTAGAGATAG -> TGTCGCCTTTAGAGATAGG
CTGTCGTGCCATATCACTC -> TGTCGTGCCATATCACTCC
CTGTTCCCGCGTTGCTAGA -> TGTTCCCGCGTTGCTAGAG
CTGTTGATTAAGTGTCGAG -> TGTTGATTAAGTGTCGAGA
CTGTTTTCTGAACCTGCAT -> TGTTTTCTGAACCTGCATC
CTGTTTTTGCAATGACCAC -> TGTTTTTGCAATGACCACC
CTTACGCATACCATTACTG -> TTACGCATACCATTACTGA
CTTACTTCCACGGCAGTTC -> TTACTTCCACGGCAGTTCA
CTTAGAGACCCATAGGTCG -> TTAGAGACCCATAGGTCGT
CTTAGTTCAGCGCGCACGA -> TTAGTTCAGCGCGCACGAG
CTTATCAGACACACAGGGT -> TTATCAGACACACAGGGTC
CTTCAAAGACCACCTATAA -> TTCAAAGACCACCTATAAC
CTTCAATTTTTCTCGCAAG -> TTCAATTTTTCTCGCAAGC
CTTCCACGGCAGTTCAACA -> TTCCACGGCAGTTCAACAG
CTTCCTGTCACGTCACGCG -> TTCCTGTCACGTCACGCGA
CTTCGAGAGCGCTTCTGGG -> TTCGAGAGCGCTTCTGGGT
CTTCTCTCTGGATCCCTGG -> TTCTCTCTGGATCCCTGGC
CTTCTGGAATCATTCTTTA -> TTCTGGAATCATTCTTTAG
CTTCTGGGTGGTTGTGTTG -> TTCTGGGTGGTTGTGTTGA,TTCTGGGTGGTTGTGTTGA,TTCTGGGTGGTTGTGTTGC,TTCTGGGTGGTTGTGTTGT
CTTCTGGTGTGATATACTT -> TTCTGGTGTGATATACTTG
CTTCTGGTTAGAGACTTAC -> TTCTGGTTAGAGACTTACT
CTTCTGTTTTTGCAATGAC -> TTCTGTTTTTGCAATGACC
CTTGAGATTTCTCGTTGTC -> TTGAGATTTCTCGTTGTCT
CTTGAGCCTATATGGATCC -> TTGAGCCTATATGGATCCG
CTTGCTTCTGGAATCATTC -> TTGCTTCTGGAATCATTCT
CTTGGATCGACGTCTTCTG -> TTGGATCGACGTCTTCTGG
CTTGGGCCTGACTCGAGCT -> TTGGGCCTGACTCGAGCTT
CTTGTAGATTAGGGCCTAT -> TTGTAGATTAGGGCCTATG
CTTGTCACAGTTCGTCGGA -> TTGTCACAGTTCGTCGGAT
CTTGTCCTCTCTACATTAT -> TTGTCCTCTCTACATTATC
CTTTACGCACTCGTCCAGT -> TTTACGCACTCGTCCAGTC
CTTTAGAGATAGGCATTCG -> TTTAGAGATAGGCATTCGT
CTTTAGGCTAGAGACGCTA -> TTTAGGCTAGAGACGCTAT
CTTTCTTCTCTCTGGATCC -> TTTCTTCTCTCTGGATCCC
CTTTGCTCCCCTAAGACTA -> TTTGCTCCCCTAAGACTAC
CTTTTATTTCCGTGGTAAC -> TTTTATTTCCGTGGTAACC
GAAAACATGAGTTATCATT -> AAAACATGAGTTATCATTT
GAAACCTATATCGGAGCGA -> AAACCTATATCGGAGCGAT
GAAACTGTTGATTAAGTGT -> AAACTGTTGATTAAGTGTC
GAAAGGGACCCCGCGATGG -> AAAGGGACCCCGCGATGGG
GAACAACCTCTTCAATTTT -> AACAACCTCTTCAATTTTT
GAACCTGCATCATTCTAGC -> AACCTGCATCATTCTAGCT
GAACGAGTCAGGCCGGCTA -> AACGAGTCAGGCCGGCTAT
GAACGCGTGGATCATGTCC -> AACGCGTGGATCATGTCCA
GAACTACACACACCACGAA -> AACTACACACACCACGAAG
GAACTACCCCTGTTTTCTG -> AACTACCCCTGTTTTCTGA
GAAGCAGCTTAGTTCAGCG -> AAGCAGCTTAGTTCAGCGC
GAAGCGAATGTTTGCAGAA -> AAGCGAATGTTTGCAGAAA
GAAGGGCAGGACGAGACAT -> AAGGGCAGGACGAGACATC
GAAGGTAAAGCCGTCTAGA -> AAGGTAAAGCCGTCTAGAA
GAAGGTTATGCATTTACCA -> AAGGTTATGCATTTACCAC
GAAGTGCTCTTTCTTCTCT -> AAGTGCTCTTTCTTCTCTC
GAATCAGAGCCTAGCTGTC -> AATCAGAGCCTAGCTGTCG
GAATCAGTCTACCCAGTGA -> AATCAGTCTACCCAGTGAT
GAATCATTCTTTAGGCTAG -> AATCATTCTTTAGGCTAGA
GAATCTGAAACTGTTGATT -> AATCTGAAACTGTTGATTA
GAATGTTTGCAGAAAGGGA -> AATGTTTGCAGAAAGGGAC
GAATTCCCCCGTTGGCAAT -> AATTCCCCCGTTGGCAATT
GAATTCGACACCCATCGGA -> AATTCGACACCCATCGGAG
GAATTTCCTCGGAAAACAT -> AATTTCCTCGGAAAACATG
GACAAAGGCCTCACAAACT -> ACAAAGGCCTCACAAACTG
GACAATTTCGCTCGGATCC -> ACAATTTCGCTCGGATCCT
GACACAAGCTAGGCAGCGG -> ACACAAGCTAGGCAGCGGC
GACACACAGGGTCCTTGTA -> ACACACAGGGTCCTTGTAG
GACACCCATCGGAGGCCTA -> ACACCCATCGGAGGCCTAT
GACAGCCGTTTGTAGAGCT -> ACAGCCGTTTGTAGAGCTG
GACATAATGTCTCGCTTTA -> ACATAATGTCTCGCTTTAC
GACATCACACGATTATGCA -> ACATCACACGATTATGCAA
GACATCCTGATTTAGGTAC -> ACATCCTGATTTAGGTACT
GACCAACCATAATGTACGT -> ACCAACCATAATGTACGTT
GACCACCATTTAGAGGCGC -> ACCACCATTTAGAGGCGCA
GACCACCTATAACACATAC -> ACCACCTATAACACATACA
GACCCACCAGGTGGTAGAA -> ACCCACCAGGTGGTAGAAT
GACCCATAGGTCGTTCTCT -> ACCCATAGGTCGTTCTCTG
GACCCCGCGATGGGCAACT -> ACCCCGCGATGGGCAACTT
GACCGGACAAAGGCCTCAC -> ACCGGACAAAGGCCTCACA
GACCTCCCGTAGATGTTTC -> ACCTCCCGTAGATGTTTCA
GACCTCTGCGTCGTCTAGC -> ACCTCTGCGTCGTCTAGCC
GACGAGACATCACACGATT -> ACGAGACATCACACGATTA
GACGCCATTGCTGCAGTCG -> ACGCCATTGCTGCAGTCGG
GACGCTATCGCTAGGAACA -> ACGCTATCGCTAGGAACAA
GACGGTCCTCACACTAAGC -> ACGGTCCTCACACTAAGCG
GACGGTTCGCGCTCAGTAG -> ACGGTTCGCGCTCAGTAGG
GACGTAAAAATCAACTTGG -> ACGTAAAAATCAACTTGGG
GACGTCTTCTGGGTGGTTG -> ACGTCTTCTGGGTGGTTGT
GACTACTACGGAGTTTCAG -> ACTACTACGGAGTTTCAGC
GACTCCTCAAAAATATCTC -> ACTCCTCAAAAATATCTCT
GACTCGAGCTTCTGGTTAG -> ACTCGAGCTTCTGGTTAGA
GACTTACTTCCACGGCAGT -> ACTTACTTCCACGGCAGTT
GACTTTTATTTCCGTGGTA -> ACTTTTATTTCCGTGGTAA
GAGAATCAGTCTACCCAGT -> AGAATCAGTCTACCCAGTG
GAGACAATTTCGCTCGGAT -> AGACAATTTCGCTCGGATC
GAGACATCACACGATTATG -> AGACATCACACGATTATGC
GAGACCCATAGGTCGTTCT -> AGACCCATAGGTCGTTCTC
GAGACGCCATTGCTGCAGT -> AGACGCCATTGCTGCAGTC
GAGACGCTATCGCTAGGAA -> AGACGCTATCGCTAGGAAC
GAGACTTACTTCCACGGCA -> AGACTTACTTCCACGGCAG
GAGAGCGCTTCTGGGTGGT -> AGAGCGCTTCTGGGTGGTT
GAGATAGGCATTCGTGCGG -> AGATAGGCATTCGTGCGGT
GAGATTTCTCGTTGTCTCG -> AGATTTCTCGTTGTCTCGT
GAGCAACCCGAGGGGGGGG -> AGCAACCCGAGGGGGGGGC
GAGCCTAGCTGTCGTGCCA -> AGCCTAGCTGTCGTGCCAT
GAGCCTATATGGATCCGTC -> AGCCTATATGGATCCGTCC
GAGCGATCCTAGTTCAATT -> AGCGATCCTAGTTCAATTT
GAGCGATCCTCTTCGAGAG -> AGCGATCCTCTTCGAGAGC
GAGCGATCCTGCTCGGAGG -> AGCGATCCTGCTCGGAGGG
GAGCGATCCTTGGATCGAC -> AGCGATCCTTGGATCGACG
GAGCGCTTCTGGGTGGTTG -> AGCGCTTCTGGGTGGTTGT
GAGCGGCGCTGTCAAAGTT -> AGCGGCGCTGTCAAAGTTG
GAGCGGGGGGGCGAATTCC -> AGCGGGGGGGCGAATTCCC
GAGCTACCAACGCAGGACA -> AGCTACCAACGCAGGACAT
GAGCTATTCTACCGTTTGA -> AGCTATTCTACCGTTTGAC
GAGCTGGGCACGGGAAGGT -> AGCTGGGCACGGGAAGGTT
GAGCTTCTGGTTAGAGACT -> AGCTTCTGGTTAGAGACTT
GAGGATGTCGCGGAATTTC -> AGGATGTCGCGGAATTTCC
GAGGCCTATTTAGATAAGT -> AGGCCTATTTAGATAAGTT
GAGGCGCAGAGACAATTTC -> AGGCGCAGAGACAATTTCG
GAGGGACTTTTATTTCCGT -> AGGGACTTTTATTTCCGTG
GAGGGGGCAGGGTGCCCCC -> AGGGGGCAGGGTGCCCCCG
GAGGGGGGGGCCGTAGGTT -> AGGGGGGGGCCGTAGGTTC
GAGGGTCTTCTGGGTGGTT -> AGGGTCTTCTGGGTGGTTG
GAGTCAGGCCGGCTATATC -> AGTCAGGCCGGCTATATCG
GAGTGCTCTAATGACATAA -> AGTGCTCTAATGACATAAT
GAGTTATCATTTTAAAGGG -> AGTTATCATTTTAAAGGGA
GAGTTTCAGCCGCGGTTGG -> AGTTTCAGCCGCGGTTGGG
GAGTTTTGCCGGCTATCAT -> AGTTTTGCCGGCTATCATG
GATAAAAACCCATGCACTT -> ATAAAAACCCATGCACTTA
GATAACGCATTGACTCCTC -> ATAACGCATTGACTCCTCA
GATAAGTTCTATATCGGAG -> ATAAGTTCTATATCGGAGC
GATACGCATATGGGGCAAC -> ATACGCATATGGGGCAACG
GATAGGCATTCGTGCGGTA -> ATAGGCATTCGTGCGGTAT
GATATACTTGTCCTCTCTA -> ATATACTTGTCCTCTCTAC
GATCATGTCCAGTGTTATA -> ATCATGTCCAGTGTTATAG
GATCCCTGGCCACACGGTC -> ATCCCTGGCCACACGGTCC
GATCCGTCCCGATACGCAT -> ATCCGTCCCGATACGCATA
GATCCTAGTTCAATTTTCT -> ATCCTAGTTCAATTTTCTT
GATCCTCGTTAATCAAGCC -> ATCCTCGTTAATCAAGCCT
GATCCTCTTCGAGAGCGCT -> ATCCTCTTCGAGAGCGCTT
GATCCTGCTCGGAGGGTCT -> ATCCTGCTCGGAGGGTCTT
GATCCTTATCAGACACACA -> ATCCTTATCAGACACACAG
GATCCTTGGATCGACGTCT -> ATCCTTGGATCGACGTCTT
GATCGACGTCTTCTGGGTG -> ATCGACGTCTTCTGGGTGG
GATCGATTGGTTTTGTTTA -> ATCGATTGGTTTTGTTTAC
GATCGTAACCATAAGTGGC -> ATCGTAACCATAAGTGGCC
GATGGAACGCGTGGATCAT -> ATGGAACGCGTGGATCATG
GATGGATAACGCATTGACT -> ATGGATAACGCATTGACTC
GATGGGCAACTTACGCATA -> ATGGGCAACTTACGCATAC
GATGTATCCTGTCCGAGCA -> ATGTATCCTGTCCGAGCAA
GATGTCGCGGAATTTCCTC -> ATGTCGCGGAATTTCCTCG
GATGTTTCATAATTTTTTG -> ATGTTTCATAATTTTTTGG
GATTAAGTCGCAGCGAAGA -> ATTAAGTCGCAGCGAAGAG
GATTAAGTGTCGAGAATCA -> ATTAAGTGTCGAGAATCAG
GATTAATATCGCCGACCAA -> ATTAATATCGCCGACCAAC
GATTAGGGCCTATGGCCTT -> ATTAGGGCCTATGGCCTTG
GATTATGCAAGCTAGGTAG -> ATTATGCAAGCTAGGTAGA
GATTGGTTTTGTTTACTAG -> ATTGGTTTTGTTTACTAGA
GATTTAGGTACTATATCGG -> ATTTAGGTACTATATCGGA
GATTTCTCGTTGTCTCGTC -> ATTTCTCGTTGTCTCGTCC
GCAACCCGAGGGGGGGGCC -> CAACCCGAGGGGGGGGCCG
GCAACGGCTTCAAAGACCA -> CAACGGCTTCAAAGACCAC
GCAACTGTCCGTGATGGAA -> CAACTGTCCGTGATGGAAC
GCAACTTACGCATACCATT -> CAACTTACGCATACCATTA
GCAAGCCTGACCGGACAAA -> CAAGCCTGACCGGACAAAG
GCAAGCTAGGTAGACCTCC -> CAAGCTAGGTAGACCTCCC
GCAAGTACTTCTGGTGTGA -> CAAGTACTTCTGGTGTGAT
GCAATGACCACCATTTAGA -> CAATGACCACCATTTAGAG
GCAATTCACCATTTAGGAA -> CAATTCACCATTTAGGAAT
GCAATTTTTTGCAGCTTCT -> CAATTTTTTGCAGCTTCTG
GCACGAGCGGGGGGGCGAA -> CACGAGCGGGGGGGCGAAT
GCACGGGAAGGTTATGCAT -> CACGGGAAGGTTATGCATT
GCACTACGGGCGTCGTTTT -> CACTACGGGCGTCGTTTTT
GCACTATTACGCGGGGGAT -> CACTATTACGCGGGGGATA
GCACTCGTCCAGTCCTTGT -> CACTCGTCCAGTCCTTGTC
GCACTTAGAGACCCATAGG -> CACTTAGAGACCCATAGGT
GCAGAAAGGGACCCCGCGA -> CAGAAAGGGACCCCGCGAT
GCAGAGACAATTTCGCTCG -> CAGAGACAATTTCGCTCGG
GCAGCGGCGTCCAATCACA -> CAGCGGCGTCCAATCACAC
GCAGCTTAGTTCAGCGCGC -> CAGCTTAGTTCAGCGCGCA
GCAGCTTCTGTTTTTGCAA -> CAGCTTCTGTTTTTGCAAT
GCAGGACATCCTGATTTAG -> CAGGACATCCTGATTTAGG
GCAGGACGAGACATCACAC -> CAGGACGAGACATCACACG
GCAGGGTGCCCCCGACGGT -> CAGGGTGCCCCCGACGGTT
GCAGTCGGTCCCCGTCCCC -> CAGTCGGTCCCCGTCCCCT
GCAGTTCAACAGGCGCACT -> CAGTTCAACAGGCGCACTA
GCATACCATTACTGACCCA -> CATACCATTACTGACCCAC
GCATAGAAGGTAAAGCCGT -> CATAGAAGGTAAAGCCGTC
GCATATGGGGCAACGGCTT -> CATATGGGGCAACGGCTTC
GCATCATTCTAGCTCGATG -> CATCATTCTAGCTCGATGT
GCATCGGACAGCCGTTTGT -> CATCGGACAGCCGTTTGTA
GCATCTCCTGTCCCTAGGC -> CATCTCCTGTCCCTAGGCT
GCATTCGTGCGGTATCCGG -> CATTCGTGCGGTATCCGGT
GCATTGACTCCTCAAAAAT -> CATTGACTCCTCAAAAATA
GCATTTACCACATAGCTAG -> CATTTACCACATAGCTAGA
GCCACACGGTCCGCTGCCC -> CCACACGGTCCGCTGCCCG
GCCAGTTTCCAGTAATTCG -> CCAGTTTCCAGTAATTCGT
GCCATATCACTCCTCAGTG -> CCATATCACTCCTCAGTGT
GCCATTGCTGCAGTCGGTC -> CCATTGCTGCAGTCGGTCC
GCCCAGTCCGCATCTCCTG -> CCCAGTCCGCATCTCCTGT
GCCCCCGACGGTTCGCGCT -> CCCCCGACGGTTCGCGCTC
GCCCGCCTATCGTTTTTAG -> CCCGCCTATCGTTTTTAGC
GCCCGGCTAAACGCCCGCC -> CCCGGCTAAACGCCCGCCT
GCCCTTTGCTCCCCTAAGA -> CCCTTTGCTCCCCTAAGAC
GCCGACCAACCATAATGTA -> CCGACCAACCATAATGTAC
GCCGCGGTTGGGCTGTATC -> CCGCGGTTGGGCTGTATCG
GCCGGACGTAAAAATCAAC -> CCGGACGTAAAAATCAACT
GCCGGCCCAGTCCGCATCT -> CCGGCCCAGTCCGCATCTC
GCCGGCTATATCGGAGCGA -> CCGGCTATATCGGAGCGAT
GCCGGCTATCATGTACTAT -> CCGGCTATCATGTACTATC
GCCGTAGGTTCGTAGGCAA -> CCGTAGGTTCGTAGGCAAC
GCCGTCTAGAATCAGAGCC -> CCGTCTAGAATCAGAGCCT
GCCGTTTGTAGAGCTGGGC -> CCGTTTGTAGAGCTGGGCA
GCCTAGCTGTCGTGCCATA -> CCTAGCTGTCGTGCCATAT
GCCTATATGGATCCGTCCC -> CCTATATGGATCCGTCCCG
GCCTATCGTTTTTAGCAAG -> CCTATCGTTTTTAGCAAGT
GCCTATGGCCTTGCTTCTG -> CCTATGGCCTTGCTTCTGG
GCCTATTTAGATAAGTTCT -> CCTATTTAGATAAGTTCTA
GCCTCACAAACTGCTATAT -> CCTCACAAACTGCTATATC
GCCTCCTCGAGACGCCATT -> CCTCCTCGAGACGCCATTG
GCCTGACCGGACAAAGGCC -> CCTGACCGGACAAAGGCCT
GCCTGACTCGAGCTTCTGG -> CCTGACTCGAGCTTCTGGT
GCCTTGCTTCTGGAATCAT -> CCTTGCTTCTGGAATCATT
GCCTTTAGAGATAGGCATT -> CCTTTAGAGATAGGCATTC
GCGAATGTTTGCAGAAAGG -> CGAATGTTTGCAGAAAGGG
GCGAATTCCCCCGTTGGCA -> CGAATTCCCCCGTTGGCAA
GCGAGTGCTCTAATGACAT -> CGAGTGCTCTAATGACATA
GCGATCCTAGTTCAATTTT -> CGATCCTAGTTCAATTTTC
GCGATCCTCTTCGAGAGCG -> CGATCCTCTTCGAGAGCGC
GCGATCCTGCTCGGAGGGT -> CGATCCTGCTCGGAGGGTC
GCGATCCTTGGATCGACGT -> CGATCCTTGGATCGACGTC
GCGATGGGCAACTTACGCA -> CGATGGGCAACTTACGCAT
GCGCACGAGCGGGGGGGCG -> CGCACGAGCGGGGGGGCGA
GCGCACTACGGGCGTCGTT -> CGCACTACGGGCGTCGTTT
GCGCAGAGACAATTTCGCT -> CGCAGAGACAATTTCGCTC
GCGCGCACGAGCGGGGGGG -> CGCGCACGAGCGGGGGGGC
GCGCTCAGTAGGAAGCAGC -> CGCTCAGTAGGAAGCAGCT
GCGCTGTCAAAGTTGTGAT -> CGCTGTCAAAGTTGTGATT
GCGCTTCTGGGTGGTTGTG -> CGCTTCTGGGTGGTTGTGT
GCGGAATTTCCTCGGAAAA -> CGGAATTTCCTCGGAAAAC
GCGGAGTTTTGCCGGCTAT -> CGGAGTTTTGCCGGCTATC
GCGGCGCTGTCAAAGTTGT -> CGGCGCTGTCAAAGTTGTG
GCGGCGTCCAATCACACAT -> CGGCGTCCAATCACACATA
GCGGGGGATAAAAACCCAT -> CGGGGGATAAAAACCCATG
GCGGGGGGGCGAATTCCCC -> CGGGGGGGCGAATTCCCCC
GCGGTATCCGGTCACAGGC -> CGGTATCCGGTCACAGGCA
GCGGTTGGGCTGTATCGAG -> CGGTTGGGCTGTATCGAGG
GCGTCCAATCACACATATC -> CGTCCAATCACACATATCC
GCGTCGTCTAGCCAGTTTC -> CGTCGTCTAGCCAGTTTCC
GCGTCGTTTTTCCAACGGC -> CGTCGTTTTTCCAACGGCA
GCGTGGATCATGTCCAGTG -> CGTGGATCATGTCCAGTGT
GCGTGTTTAGTCTCTCCGG -> CGTGTTTAGTCTCTCCGGA
GCGTTGCTAGAGCTATTCT -> CGTTGCTAGAGCTATTCTA
GCTAAACGCCCGCCTATCG -> CTAAACGCCCGCCTATCGT
GCTACCAACGCAGGACATC -> CTACCAACGCAGGACATCC
GCTAGAGACGCTATCGCTA -> CTAGAGACGCTATCGCTAG
GCTAGAGCTATTCTACCGT -> CTAGAGCTATTCTACCGTT
GCTAGAGGGGGCAGGGTGC -> CTAGAGGGGGCAGGGTGCC
GCTAGGAACAACCTCTTCA -> CTAGGAACAACCTCTTCAA
GCTAGGCAGCGGCGTCCAA -> CTAGGCAGCGGCGTCCAAT
GCTAGGTAGACCTCCCGTA -> CTAGGTAGACCTCCCGTAG
GCTATATCATCCAACAGTC -> CTATATCATCCAACAGTCC
GCTATATCGGAGCGATCCT -> CTATATCGGAGCGATCCTG
GCTATCATGTACTATCGTC -> CTATCATGTACTATCGTCC
GCTATCGCTAGGAACAACC -> CTATCGCTAGGAACAACCT
GCTATTCTACCGTTTGACC -> CTATTCTACCGTTTGACCT
GCTCAGTAGGAAGCAGCTT -> CTCAGTAGGAAGCAGCTTA
GCTCCCCTAAGACTACTAC -> CTCCCCTAAGACTACTACG
GCTCGATGTATCCTGTCCG -> CTCGATGTATCCTGTCCGA
GCTCGGAGGGTCTTCTGGG -> CTCGGAGGGTCTTCTGGGT
GCTCGGATCCTCGTTAATC -> CTCGGATCCTCGTTAATCA
GCTCTAATGACATAATGTC -> CTCTAATGACATAATGTCT
GCTCTTTCTTCTCTCTGGA -> CTCTTTCTTCTCTCTGGAT
GCTGAGCGGCGCTGTCAAA -> CTGAGCGGCGCTGTCAAAG
GCTGCAGTCGGTCCCCGTC -> CTGCAGTCGGTCCCCGTCC
GCTGCCCGGCTAAACGCCC -> CTGCCCGGCTAAACGCCCG
GCTGGGCACGGGAAGGTTA -> CTGGGCACGGGAAGGTTAT
GCTGTACCTCTACCCTATG -> CTGTACCTCTACCCTATGG
GCTGTATCGAGGATGTCGC -> CTGTATCGAGGATGTCGCG
GCTGTATGCTGTACCTCTA -> CTGTATGCTGTACCTCTAC
GCTGTCAAAGTTGTGATTA -> CTGTCAAAGTTGTGATTAA
GCTGTCGTGCCATATCACT -> CTGTCGTGCCATATCACTC
GCTTAGTTCAGCGCGCACG -> CTTAGTTCAGCGCGCACGA
GCTTCAAAGACCACCTATA -> CTTCAAAGACCACCTATAA
GCTTCTGGAATCATTCTTT -> CTTCTGGAATCATTCTTTA
GCTTCTGGGTGGTTGTGTT -> CTTCTGGGTGGTTGTGTTG
GCTTCTGGTTAGAGACTTA -> CTTCTGGTTAGAGACTTAC
GCTTCTGTTTTTGCAATGA -> CTTCTGTTTTTGCAATGAC
GCTTTACGCACTCGTCCAG -> CTTTACGCACTCGTCCAGT
GGAAAACATGAGTTATCAT -> GAAAACATGAGTTATCATT
GGAACAACCTCTTCAATTT -> GAACAACCTCTTCAATTTT
GGAACGCGTGGATCATGTC -> GAACGCGTGGATCATGTCC
GGAACTACCCCTGTTTTCT -> GAACTACCCCTGTTTTCTG
GGAAGCAGCTTAGTTCAGC -> GAAGCAGCTTAGTTCAGCG
GGAAGGTTATGCATTTACC -> GAAGGTTATGCATTTACCA
GGAATCATTCTTTAGGCTA -> GAATCATTCTTTAGGCTAG
GGAATTCGACACCCATCGG -> GAATTCGACACCCATCGGA
GGAATTTCCTCGGAAAACA -> GAATTTCCTCGGAAAACAT
GGACAAAGGCCTCACAAAC -> GACAAAGGCCTCACAAACT
GGACACAAGCTAGGCAGCG -> GACACAAGCTAGGCAGCGG
GGACAGCCGTTTGTAGAGC -> GACAGCCGTTTGTAGAGCT
GGACATCCTGATTTAGGTA -> GACATCCTGATTTAGGTAC
GGACCCCGCGATGGGCAAC -> GACCCCGCGATGGGCAACT
GGACGAGACATCACACGAT -> GACGAGACATCACACGATT
GGACGGTCCTCACACTAAG -> GACGGTCCTCACACTAAGC
GGACGTAAAAATCAACTTG -> GACGTAAAAATCAACTTGG
GGACTTTTATTTCCGTGGT -> GACTTTTATTTCCGTGGTA
GGAGCGATCCTAGTTCAAT -> GAGCGATCCTAGTTCAATT
GGAGCGATCCTCTTCGAGA -> GAGCGATCCTCTTCGAGAG
GGAGCGATCCTGCTCGGAG -> GAGCGATCCTGCTCGGAGG
GGAGCGATCCTTGGATCGA -> GAGCGATCCTTGGATCGAC
GGAGGCCTATTTAGATAAG -> GAGGCCTATTTAGATAAGT
GGAGGGTCTTCTGGGTGGT -> GAGGGTCTTCTGGGTGGTT
GGAGTTTCAGCCGCGGTTG -> GAGTTTCAGCCGCGGTTGG
GGAGTTTTGCCGGCTATCA -> GAGTTTTGCCGGCTATCAT
GGATAAAAACCCATGCACT -> GATAAAAACCCATGCACTT
GGATAACGCATTGACTCCT -> GATAACGCATTGACTCCTC
GGATCATGTCCAGTGTTAT -> GATCATGTCCAGTGTTATA
GGATCCCTGGCCACACGGT -> GATCCCTGGCCACACGGTC
GGATCCGTCCCGATACGCA -> GATCCGTCCCGATACGCAT
GGATCCTCGTTAATCAAGC -> GATCCTCGTTAATCAAGCC
GGATCGACGTCTTCTGGGT -> GATCGACGTCTTCTGGGTG
GGATCGTAACCATAAGTGG -> GATCGTAACCATAAGTGGC
GGATGTCGCGGAATTTCCT -> GATGTCGCGGAATTTCCTC
GGATTAAGTCGCAGCGAAG -> GATTAAGTCGCAGCGAAGA
GGCAACGGCTTCAAAGACC -> GCAACGGCTTCAAAGACCA
GGCAACTGTCCGTGATGGA -> GCAACTGTCCGTGATGGAA
GGCAACTTACGCATACCAT -> GCAACTTACGCATACCATT
GGCAATTCACCATTTAGGA -> GCAATTCACCATTTAGGAA
GGCACGGGAAGGTTATGCA -> GCACGGGAAGGTTATGCAT
GGCACTATTACGCGGGGGA -> GCACTATTACGCGGGGGAT
GGCAGCGGCGTCCAATCAC -> GCAGCGGCGTCCAATCACA
GGCAGGACGAGACATCACA -> GCAGGACGAGACATCACAC
GGCAGGGTGCCCCCGACGG -> GCAGGGTGCCCCCGACGGT
GGCAGTTCAACAGGCGCAC -> GCAGTTCAACAGGCGCACT
GGCATCGGACAGCCGTTTG -> GCATCGGACAGCCGTTTGT
GGCATTCGTGCGGTATCCG -> GCATTCGTGCGGTATCCGG
GGCCACACGGTCCGCTGCC -> GCCACACGGTCCGCTGCCC
GGCCCAGTCCGCATCTCCT -> GCCCAGTCCGCATCTCCTG
GGCCCTTTGCTCCCCTAAG -> GCCCTTTGCTCCCCTAAGA
GGCCGGACGTAAAAATCAA -> GCCGGACGTAAAAATCAAC
GGCCGGCCCAGTCCGCATC -> GCCGGCCCAGTCCGCATCT
GGCCGGCTATATCGGAGCG -> GCCGGCTATATCGGAGCGA
GGCCGTAGGTTCGTAGGCA -> GCCGTAGGTTCGTAGGCAA
GGCCTATGGCCTTGCTTCT -> GCCTATGGCCTTGCTTCTG
GGCCTATTTAGATAAGTTC -> GCCTATTTAGATAAGTTCT
GGCCTCACAAACTGCTATA -> GCCTCACAAACTGCTATAT
GGCCTGACTCGAGCTTCTG -> GCCTGACTCGAGCTTCTGG
GGCCTTGCTTCTGGAATCA -> GCCTTGCTTCTGGAATCAT
GGCGAATTCCCCCGTTGGC -> GCGAATTCCCCCGTTGGCA
GGCGCACTACGGGCGTCGT -> GCGCACTACGGGCGTCGTT
GGCGCAGAGACAATTTCGC -> GCGCAGAGACAATTTCGCT
GGCGCTGTCAAAGTTGTGA -> GCGCTGTCAAAGTTGTGAT
GGCGGAGTTTTGCCGGCTA -> GCGGAGTTTTGCCGGCTAT
GGCGTCCAATCACACATAT -> GCGTCCAATCACACATATC
GGCGTCGTTTTTCCAACGG -> GCGTCGTTTTTCCAACGGC
GGCTAAACGCCCGCCTATC -> GCTAAACGCCCGCCTATCG
GGCTAGAGACGCTATCGCT -> GCTAGAGACGCTATCGCTA
GGCTATATCGGAGCGATCC -> GCTATATCGGAGCGATCCT
GGCTATCATGTACTATCGT -> GCTATCATGTACTATCGTC
GGCTGTATCGAGGATGTCG -> GCTGTATCGAGGATGTCGC
GGCTGTATGCTGTACCTCT -> GCTGTATGCTGTACCTCTA
GGCTTCAAAGACCACCTAT -> GCTTCAAAGACCACCTATA
GGGAACTACCCCTGTTTTC -> GGAACTACCCCTGTTTTCT
GGGAAGGTTATGCATTTAC -> GGAAGGTTATGCATTTACC
GGGACCCCGCGATGGGCAA -> GGACCCCGCGATGGGCAAC
GGGACGGTCCTCACACTAA -> GGACGGTCCTCACACTAAG
GGGACTTTTATTTCCGTGG -> GGACTTTTATTTCCGTGGT
GGGATAAAAACCCATGCAC -> GGATAAAAACCCATGCACT
GGGCAACGGCTTCAAAGAC -> GGCAACGGCTTCAAAGACC
GGGCAACTTACGCATACCA -> GGCAACTTACGCATACCAT
GGGCACGGGAAGGTTATGC -> GGCACGGGAAGGTTATGCA
GGGCAGGACGAGACATCAC -> GGCAGGACGAGACATCACA
GGGCAGGGTGCCCCCGACG -> GGCAGGGTGCCCCCGACGG
GGGCCGGCCCAGTCCGCAT -> GGCCGGCCCAGTCCGCATC
GGGCCGTAGGTTCGTAGGC -> GGCCGTAGGTTCGTAGGCA
GGGCCTATGGCCTTGCTTC -> GGCCTATGGCCTTGCTTCT
GGGCCTGACTCGAGCTTCT -> GGCCTGACTCGAGCTTCTG
GGGCGAATTCCCCCGTTGG -> GGCGAATTCCCCCGTTGGC
GGGCGTCGTTTTTCCAACG -> GGCGTCGTTTTTCCAACGG
GGGCTGTATCGAGGATGTC -> GGCTGTATCGAGGATGTCG
GGGGATAAAAACCCATGCA -> GGGATAAAAACCCATGCAC
GGGGCAACGGCTTCAAAGA -> GGGCAACGGCTTCAAAGAC
GGGGCAGGGTGCCCCCGAC -> GGGCAGGGTGCCCCCGACG
GGGGCCGTAGGTTCGTAGG -> GGGCCGTAGGTTCGTAGGC
GGGGCGAATTCCCCCGTTG -> GGGCGAATTCCCCCGTTGG
GGGGGATAAAAACCCATGC -> GGGGATAAAAACCCATGCA
GGGGGCAGGGTGCCCCCGA -> GGGGCAGGGTGCCCCCGAC
GGGGGCCGTAGGTTCGTAG -> GGGGCCGTAGGTTCGTAGG
GGGGGCGAATTCCCCCGTT -> GGGGCGAATTCCCCCGTTG
GGGGGGCCGTAGGTTCGTA -> GGGGGCCGTAGGTTCGTAG
GGGGGGCGAATTCCCCCGT -> GGGGGCGAATTCCCCCGTT
GGGGGGGCCGTAGGTTCGT -> GGGGGGCCGTAGGTTCGTA
GGGGGGGCGAATTCCCCCG -> GGGGGGCGAATTCCCCCGT
GGGGGGGGCCGTAGGTTCG -> GGGGGGGCCGTAGGTTCGT
GGGTCCTTGTAGATTAGGG -> GGTCCTTGTAGATTAGGGC
GGGTCTTCTGGGTGGTTGT -> GGTCTTCTGGGTGGTTGTG
GGGTGCCCCCGACGGTTCG -> GGTGCCCCCGACGGTTCGC
GGGTGGTTGTGTTGAACTA -> GGTGGTTGTGTTGAACTAC
GGGTGGTTGTGTTGATCGA -> GGTGGTTGTGTTGATCGAT
GGGTGGTTGTGTTGCATAG -> GGTGGTTGTGTTGCATAGA
GGGTGGTTGTGTTGTAATG -> GGTGGTTGTGTTGTAATGT
GGGTTTATGGCCCTTTGCT -> GGTTTATGGCCCTTTGCTC
GGTAAAGCCGTCTAGAATC -> GTAAAGCCGTCTAGAATCA
GGTAACCGATGGATAACGC -> GTAACCGATGGATAACGCA
GGTACTATATCGGAGCGAT -> GTACTATATCGGAGCGATC
GGTAGAATCTGAAACTGTT -> GTAGAATCTGAAACTGTTG
GGTAGACCTCCCGTAGATG -> GTAGACCTCCCGTAGATGT
GGTATCCGGTCACAGGCAT -> GTATCCGGTCACAGGCATC
GGTCACAGGCATCGGACAG -> GTCACAGGCATCGGACAGC
GGTCCCCGTCCCCTTCCTG -> GTCCCCGTCCCCTTCCTGT
GGTCCGCTGCCCGGCTAAA -> GTCCGCTGCCCGGCTAAAC
GGTCCTCACACTAAGCGTG -> GTCCTCACACTAAGCGTGT
GGTCCTTGTAGATTAGGGC -> GTCCTTGTAGATTAGGGCC
GGTCGTTCTCTGTCGCCTT -> GTCGTTCTCTGTCGCCTTT
GGTCTTCTGGGTGGTTGTG -> GTCTTCTGGGTGGTTGTGT
GGTGCCCCCGACGGTTCGC -> GTGCCCCCGACGGTTCGCG
GGTGGTAGAATCTGAAACT -> GTGGTAGAATCTGAAACTG
GGTGGTTGTGTTGAACTAC -> GTGGTTGTGTTGAACTACA
GGTGGTTGTGTTGATCGAT -> GTGGTTGTGTTGATCGATT
GGTGGTTGTGTTGCATAGA -> GTGGTTGTGTTGCATAGAA
GGTGGTTGTGTTGTAATGT -> GTGGTTGTGTTGTAATGTA
GGTGTGATATACTTGTCCT -> GTGTGATATACTTGTCCTC
GGTTAGAGACTTACTTCCA -> GTTAGAGACTTACTTCCAC
GGTTATGCATTTACCACAT -> GTTATGCATTTACCACATA
GGTTCGCGCTCAGTAGGAA -> GTTCGCGCTCAGTAGGAAG
GGTTCGTAGGCAACTGTCC -> GTTCGTAGGCAACTGTCCG
GGTTGGGCTGTATCGAGGA -> GTTGGGCTGTATCGAGGAT
GGTTGTGTTGAACTACACA -> GTTGTGTTGAACTACACAC
GGTTGTGTTGATCGATTGG -> GTTGTGTTGATCGATTGGT
GGTTGTGTTGCATAGAAGG -> GTTGTGTTGCATAGAAGGT
GGTTGTGTTGTAATGTAAG -> GTTGTGTTGTAATGTAAGC
GGTTTATGGCCCTTTGCTC -> GTTTATGGCCCTTTGCTCC
GGTTTTGTTTACTAGAAGC -> GTTTTGTTTACTAGAAGCG
GTAAAAATCAACTTGGGCC -> TAAAAATCAACTTGGGCCT
GTAAAGCCGTCTAGAATCA -> TAAAGCCGTCTAGAATCAG
GTAACCATAAGTGGCCGGA -> TAACCATAAGTGGCCGGAC
GTAACCGATGGATAACGCA -> TAACCGATGGATAACGCAT
GTAAGCAATTTTTTGCAGC -> TAAGCAATTTTTTGCAGCT
GTAATGTAAGCAATTTTTT -> TAATGTAAGCAATTTTTTG
GTAATTCGTACCCAACAGT -> TAATTCGTACCCAACAGTA
GTACCATCTCCTTGAGCCT -> TACCATCTCCTTGAGCCTA
GTACCCAACAGTACCATCT -> TACCCAACAGTACCATCTC
GTACCTCTACCCTATGGGT -> TACCTCTACCCTATGGGTT
GTACGTTGAGGGACTTTTA -> TACGTTGAGGGACTTTTAT
GTACTATATCGGAGCGATC -> TACTATATCGGAGCGATCC
GTACTATCGTCCCAAGCTG -> TACTATCGTCCCAAGCTGA
GTACTTCTGGTGTGATATA -> TACTTCTGGTGTGATATAC
GTAGAATCTGAAACTGTTG -> TAGAATCTGAAACTGTTGA
GTAGACCTCCCGTAGATGT -> TAGACCTCCCGTAGATGTT
GTAGAGCTGGGCACGGGAA -> TAGAGCTGGGCACGGGAAG
GTAGATGTTTCATAATTTT -> TAGATGTTTCATAATTTTT
GTAGATTAGGGCCTATGGC -> TAGATTAGGGCCTATGGCC
GTAGGAAGCAGCTTAGTTC -> TAGGAAGCAGCTTAGTTCA
GTAGGCAACTGTCCGTGAT -> TAGGCAACTGTCCGTGATG
GTAGGTTCGTAGGCAACTG -> TAGGTTCGTAGGCAACTGT
GTATCCGGTCACAGGCATC -> TATCCGGTCACAGGCATCG
GTATCCTGTCCGAGCAACC -> TATCCTGTCCGAGCAACCC
GTATCGAGGATGTCGCGGA -> TATCGAGGATGTCGCGGAA
GTATGCTGTACCTCTACCC -> TATGCTGTACCTCTACCCT
GTCAAAGTTGTGATTAATA -> TCAAAGTTGTGATTAATAT
GTCACAGGCATCGGACAGC -> TCACAGGCATCGGACAGCC
GTCACAGTTCGTCGGATTA -> TCACAGTTCGTCGGATTAA
GTCACGCGAGTGCTCTAAT -> TCACGCGAGTGCTCTAATG
GTCACGTCACGCGAGTGCT -> TCACGTCACGCGAGTGCTC
GTCAGGCCGGCTATATCGG -> TCAGGCCGGCTATATCGGA
GTCCAATCACACATATCCT -> TCCAATCACACATATCCTG
GTCCAGTCCTTGTCACAGT -> TCCAGTCCTTGTCACAGTT
GTCCAGTGTTATAGGGACG -> TCCAGTGTTATAGGGACGG
GTCCCAAGCTGAGCGGCGC -> TCCCAAGCTGAGCGGCGCT
GTCCCCGTCCCCTTCCTGT -> TCCCCGTCCCCTTCCTGTC
GTCCCCTTCCTGTCACGTC -> TCCCCTTCCTGTCACGTCA
GTCCCGATACGCATATGGG -> TCCCGATACGCATATGGGG
GTCCCTAGGCTGTATGCTG -> TCCCTAGGCTGTATGCTGT
GTCCGAGCAACCCGAGGGG -> TCCGAGCAACCCGAGGGGG
GTCCGCATCTCCTGTCCCT -> TCCGCATCTCCTGTCCCTA
GTCCGCTGCCCGGCTAAAC -> TCCGCTGCCCGGCTAAACG
GTCCGTGATGGAACGCGTG -> TCCGTGATGGAACGCGTGG
GTCCTAATCGAGCTACCAA -> TCCTAATCGAGCTACCAAC
GTCCTCACACTAAGCGTGT -> TCCTCACACTAAGCGTGTT
GTCCTCGAACGAGTCAGGC -> TCCTCGAACGAGTCAGGCC
GTCCTCTCTACATTATCGA -> TCCTCTCTACATTATCGAA
GTCCTTGTAGATTAGGGCC -> TCCTTGTAGATTAGGGCCT
GTCCTTGTCACAGTTCGTC -> TCCTTGTCACAGTTCGTCG
GTCGAGAATCAGTCTACCC -> TCGAGAATCAGTCTACCCA
GTCGCCTTTAGAGATAGGC -> TCGCCTTTAGAGATAGGCA
GTCGCGGAATTTCCTCGGA -> TCGCGGAATTTCCTCGGAA
GTCGGACACAAGCTAGGCA -> TCGGACACAAGCTAGGCAG
GTCGGATTAAGTCGCAGCG -> TCGGATTAAGTCGCAGCGA
GTCGGTCCCCGTCCCCTTC -> TCGGTCCCCGTCCCCTTCC
GTCGTCTAGCCAGTTTCCA -> TCGTCTAGCCAGTTTCCAG
GTCGTGCCATATCACTCCT -> TCGTGCCATATCACTCCTC
GTCGTTCTCTGTCGCCTTT -> TCGTTCTCTGTCGCCTTTA
GTCGTTTTTCCAACGGCAC -> TCGTTTTTCCAACGGCACT
GTCTACCCAGTGATCCTTA -> TCTACCCAGTGATCCTTAT
GTCTAGAATCAGAGCCTAG -> TCTAGAATCAGAGCCTAGC
GTCTAGCCAGTTTCCAGTA -> TCTAGCCAGTTTCCAGTAA
GTCTCGCTTTACGCACTCG -> TCTCGCTTTACGCACTCGT
GTCTCGTCCTCGAACGAGT -> TCTCGTCCTCGAACGAGTC
GTCTCTCCGGATCGTAACC -> TCTCTCCGGATCGTAACCA
GTCTTCTGGGTGGTTGTGT -> TCTTCTGGGTGGTTGTGTT,TCTTCTGGGTGGTTGTGTT
GTGATATACTTGTCCTCTC -> TGATATACTTGTCCTCTCT
GTGATCCTTATCAGACACA -> TGATCCTTATCAGACACAC
GTGATGGAACGCGTGGATC -> TGATGGAACGCGTGGATCA
GTGATTAATATCGCCGACC -> TGATTAATATCGCCGACCA
GTGCCATATCACTCCTCAG -> TGCCATATCACTCCTCAGT
GTGCCCCCGACGGTTCGCG -> TGCCCCCGACGGTTCGCGC
GTGCGGTATCCGGTCACAG -> TGCGGTATCCGGTCACAGG
GTGCTCTAATGACATAATG -> TGCTCTAATGACATAATGT
GTGCTCTTTCTTCTCTCTG -> TGCTCTTTCTTCTCTCTGG
GTGGATCATGTCCAGTGTT -> TGGATCATGTCCAGTGTTA
GTGGCCGGACGTAAAAATC -> TGGCCGGACGTAAAAATCA
GTGGTAACCGATGGATAAC -> TGGTAACCGATGGATAACG
GTGGTAGAATCTGAAACTG -> TGGTAGAATCTGAAACTGT
GTGGTTGTGTTGAACTACA -> TGGTTGTGTTGAACTACAC
GTGGTTGTGTTGATCGATT -> TGGTTGTGTTGATCGATTG
GTGGTTGTGTTGCATAGAA -> TGGTTGTGTTGCATAGAAG
GTGGTTGTGTTGTAATGTA -> TGGTTGTGTTGTAATGTAA
GTGTCGAGAATCAGTCTAC -> TGTCGAGAATCAGTCTACC
GTGTCGGACACAAGCTAGG -> TGTCGGACACAAGCTAGGC
GTGTGATATACTTGTCCTC -> TGTGATATACTTGTCCTCT
GTGTTATAGGGACGGTCCT -> TGTTATAGGGACGGTCCTC
GTGTTGAACTACACACACC -> TGTTGAACTACACACACCA
GTGTTGATCGATTGGTTTT -> TGTTGATCGATTGGTTTTG
GTGTTGCATAGAAGGTAAA -> TGTTGCATAGAAGGTAAAG
GTGTTGTAATGTAAGCAAT -> TGTTGTAATGTAAGCAATT
GTGTTTAGTCTCTCCGGAT -> TGTTTAGTCTCTCCGGATC
GTTAATCAAGCCTCCTCGA -> TTAATCAAGCCTCCTCGAG
GTTAGAGACTTACTTCCAC -> TTAGAGACTTACTTCCACG
GTTATAGGGACGGTCCTCA -> TTATAGGGACGGTCCTCAC
GTTATCATTTTAAAGGGAA -> TTATCATTTTAAAGGGAAC
GTTATGCATTTACCACATA -> TTATGCATTTACCACATAG
GTTCAACAGGCGCACTACG -> TTCAACAGGCGCACTACGG
GTTCAATTTTCTTCTGGGT -> TTCAATTTTCTTCTGGGTG
GTTCAGCGCGCACGAGCGG -> TTCAGCGCGCACGAGCGGG
GTTCCCGCGTTGCTAGAGC -> TTCCCGCGTTGCTAGAGCT
GTTCGCGCTCAGTAGGAAG -> TTCGCGCTCAGTAGGAAGC
GTTCGTAGGCAACTGTCCG -> TTCGTAGGCAACTGTCCGT
GTTCGTCGGATTAAGTCGC -> TTCGTCGGATTAAGTCGCA
GTTCTATATCGGAGCGATC -> TTCTATATCGGAGCGATCC
GTTCTCTGTCGCCTTTAGA -> TTCTCTGTCGCCTTTAGAG
GTTGAACTACACACACCAC -> TTGAACTACACACACCACG
GTTGAGGGACTTTTATTTC -> TTGAGGGACTTTTATTTCC
GTTGATCGATTGGTTTTGT -> TTGATCGATTGGTTTTGTT
GTTGATTAAGTGTCGAGAA -> TTGATTAAGTGTCGAGAAT
GTTGCATAGAAGGTAAAGC -> TTGCATAGAAGGTAAAGCC
GTTGCTAGAGCTATTCTAC -> TTGCTAGAGCTATTCTACC
GTTGGCAATTCACCATTTA -> TTGGCAATTCACCATTTAG
GTTGGGCTGTATCGAGGAT -> TTGGGCTGTATCGAGGATG
GTTGTAATGTAAGCAATTT -> TTGTAATGTAAGCAATTTT
GTTGTCTCGTCCTCGAACG -> TTGTCTCGTCCTCGAACGA
GTTGTGATTAATATCGCCG -> TTGTGATTAATATCGCCGA
GTTGTGTTGAACTACACAC -> TTGTGTTGAACTACACACA
GTTGTGTTGATCGATTGGT -> TTGTGTTGATCGATTGGTT
GTTGTGTTGCATAGAAGGT -> TTGTGTTGCATAGAAGGTA
GTTGTGTTGTAATGTAAGC -> TTGTGTTGTAATGTAAGCA
GTTTACTAGAAGCGAATGT -> TTTACTAGAAGCGAATGTT
GTTTAGTCTCTCCGGATCG -> TTTAGTCTCTCCGGATCGT
GTTTATGGCCCTTTGCTCC -> TTTATGGCCCTTTGCTCCC
GTTTCAGCCGCGGTTGGGC -> TTTCAGCCGCGGTTGGGCT
GTTTCATAATTTTTTGGGC -> TTTCATAATTTTTTGGGCC
GTTTCCAGTAATTCGTACC -> TTTCCAGTAATTCGTACCC
GTTTGACCTCTGCGTCGTC -> TTTGACCTCTGCGTCGTCT
GTTTGCAGAAAGGGACCCC -> TTTGCAGAAAGGGACCCCG
GTTTGTAGAGCTGGGCACG -> TTTGTAGAGCTGGGCACGG
GTTTTCTGAACCTGCATCA -> TTTTCTGAACCTGCATCAT
GTTTTGCCGGCTATCATGT -> TTTTGCCGGCTATCATGTA
GTTTTGTTTACTAGAAGCG -> TTTTGTTTACTAGAAGCGA
GTTTTTAGCAAGTACTTCT -> TTTTTAGCAAGTACTTCTG
GTTTTTCCAACGGCACTAT -> TTTTTCCAACGGCACTATT
GTTTTTGCAATGACCACCA -> TTTTTGCAATGACCACCAT
TAAAAACCCATGCACTTAG -> AAAAACCCATGCACTTAGA
TAAAAATCAACTTGGGCCT -> AAAAATCAACTTGGGCCTG
TAAACGCCCGCCTATCGTT -> AAACGCCCGCCTATCGTTT
TAAAGCCGTCTAGAATCAG -> AAAGCCGTCTAGAATCAGA
TAAAGGGAACTACCCCTGT -> AAAGGGAACTACCCCTGTT
TAACACATACATGAAACCT -> AACACATACATGAAACCTA
TAACCATAAGTGGCCGGAC -> AACCATAAGTGGCCGGACG
TAACCGATGGATAACGCAT -> AACCGATGGATAACGCATT
TAACGCATTGACTCCTCAA -> AACGCATTGACTCCTCAAA
TAAGACTACTACGGAGTTT -> AAGACTACTACGGAGTTTC
TAAGCAATTTTTTGCAGCT -> AAGCAATTTTTTGCAGCTT
TAAGCGTGTTTAGTCTCTC -> AAGCGTGTTTAGTCTCTCC
TAAGTCGCAGCGAAGAGAC -> AAGTCGCAGCGAAGAGACG
TAAGTGGCCGGACGTAAAA -> AAGTGGCCGGACGTAAAAA
TAAGTGTCGAGAATCAGTC -> AAGTGTCGAGAATCAGTCT
TAAGTTCTATATCGGAGCG -> AAGTTCTATATCGGAGCGA
TAATATCGCCGACCAACCA -> AATATCGCCGACCAACCAT
TAATCAAGCCTCCTCGAGA -> AATCAAGCCTCCTCGAGAC
TAATCGAGCTACCAACGCA -> AATCGAGCTACCAACGCAG
TAATGACATAATGTCTCGC -> AATGACATAATGTCTCGCT
TAATGTAAGCAATTTTTTG -> AATGTAAGCAATTTTTTGC
TAATGTACGTTGAGGGACT -> AATGTACGTTGAGGGACTT
TAATGTCTCGCTTTACGCA -> AATGTCTCGCTTTACGCAC
TAATTCGTACCCAACAGTA -> AATTCGTACCCAACAGTAC
TAATTTTTTGGGCCGGCCC -> AATTTTTTGGGCCGGCCCA
TACACACACCACGAAGTGC -> ACACACACCACGAAGTGCT
TACATGAAACCTATATCGG -> ACATGAAACCTATATCGGA
TACATTATCGAAGGGCAGG -> ACATTATCGAAGGGCAGGA
TACCAACGCAGGACATCCT -> ACCAACGCAGGACATCCTG
TACCACATAGCTAGAGGGG -> ACCACATAGCTAGAGGGGG
TACCATCTCCTTGAGCCTA -> ACCATCTCCTTGAGCCTAT
TACCATTACTGACCCACCA -> ACCATTACTGACCCACCAG
TACCCAACAGTACCATCTC -> ACCCAACAGTACCATCTCC
TACCCAGTGATCCTTATCA -> ACCCAGTGATCCTTATCAG
TACCCCTGTTTTCTGAACC -> ACCCCTGTTTTCTGAACCT
TACCCTATGGGTTTATGGC -> ACCCTATGGGTTTATGGCC
TACCGTTTGACCTCTGCGT -> ACCGTTTGACCTCTGCGTC
TACCTCTACCCTATGGGTT -> ACCTCTACCCTATGGGTTT
TACGCACTCGTCCAGTCCT -> ACGCACTCGTCCAGTCCTT
TACGCATACCATTACTGAC -> ACGCATACCATTACTGACC
TACGCATATGGGGCAACGG -> ACGCATATGGGGCAACGGC
TACGCGGGGGATAAAAACC -> ACGCGGGGGATAAAAACCC
TACGGAGTTTCAGCCGCGG -> ACGGAGTTTCAGCCGCGGT
TACGGGCGTCGTTTTTCCA -> ACGGGCGTCGTTTTTCCAA
TACGTTGAGGGACTTTTAT -> ACGTTGAGGGACTTTTATT
TACTACGGAGTTTCAGCCG -> ACTACGGAGTTTCAGCCGC
TACTAGAAGCGAATGTTTG -> ACTAGAAGCGAATGTTTGC
TACTATATCGGAGCGATCC -> ACTATATCGGAGCGATCCT
TACTATCGTCCCAAGCTGA -> ACTATCGTCCCAAGCTGAG
TACTGACCCACCAGGTGGT -> ACTGACCCACCAGGTGGTA
TACTTCCACGGCAGTTCAA -> ACTTCCACGGCAGTTCAAC
TACTTCTGGTGTGATATAC -> ACTTCTGGTGTGATATACT
TACTTGTCCTCTCTACATT -> ACTTGTCCTCTCTACATTA
TAGAAGCGAATGTTTGCAG -> AGAAGCGAATGTTTGCAGA
TAGAAGGTAAAGCCGTCTA -> AGAAGGTAAAGCCGTCTAG
TAGAATCAGAGCCTAGCTG -> AGAATCAGAGCCTAGCTGT
TAGAATCTGAAACTGTTGA -> AGAATCTGAAACTGTTGAT
TAGACCTCCCGTAGATGTT -> AGACCTCCCGTAGATGTTT
TAGAGACCCATAGGTCGTT -> AGAGACCCATAGGTCGTTC
TAGAGACGCTATCGCTAGG -> AGAGACGCTATCGCTAGGA
TAGAGACTTACTTCCACGG -> AGAGACTTACTTCCACGGC
TAGAGATAGGCATTCGTGC -> AGAGATAGGCATTCGTGCG
TAGAGCTATTCTACCGTTT -> AGAGCTATTCTACCGTTTG
TAGAGCTGGGCACGGGAAG -> AGAGCTGGGCACGGGAAGG
TAGAGGCGCAGAGACAATT -> AGAGGCGCAGAGACAATTT
TAGAGGGGGCAGGGTGCCC -> AGAGGGGGCAGGGTGCCCC
TAGATAAGTTCTATATCGG -> AGATAAGTTCTATATCGGA
TAGATGTTTCATAATTTTT -> AGATGTTTCATAATTTTTT
TAGATTAGGGCCTATGGCC -> AGATTAGGGCCTATGGCCT
TAGCAAGTACTTCTGGTGT -> AGCAAGTACTTCTGGTGTG
TAGCCAGTTTCCAGTAATT -> AGCCAGTTTCCAGTAATTC
TAGCTAGAGGGGGCAGGGT -> AGCTAGAGGGGGCAGGGTG
TAGCTCGATGTATCCTGTC -> AGCTCGATGTATCCTGTCC
TAGCTGTCGTGCCATATCA -> AGCTGTCGTGCCATATCAC
TAGGAACAACCTCTTCAAT -> AGGAACAACCTCTTCAATT
TAGGAAGCAGCTTAGTTCA -> AGGAAGCAGCTTAGTTCAG
TAGGAATTCGACACCCATC -> AGGAATTCGACACCCATCG
TAGGCAACTGTCCGTGATG -> AGGCAACTGTCCGTGATGG
TAGGCAGCGGCGTCCAATC -> AGGCAGCGGCGTCCAATCA
TAGGCATTCGTGCGGTATC -> AGGCATTCGTGCGGTATCC
TAGGCTAGAGACGCTATCG -> AGGCTAGAGACGCTATCGC
TAGGCTGTATGCTGTACCT -> AGGCTGTATGCTGTACCTC
TAGGGACGGTCCTCACACT -> AGGGACGGTCCTCACACTA
TAGGGCCTATGGCCTTGCT -> AGGGCCTATGGCCTTGCTT
TAGGTACTATATCGGAGCG -> AGGTACTATATCGGAGCGA
TAGGTAGACCTCCCGTAGA -> AGGTAGACCTCCCGTAGAT
TAGGTCGTTCTCTGTCGCC -> AGGTCGTTCTCTGTCGCCT
TAGGTTCGTAGGCAACTGT -> AGGTTCGTAGGCAACTGTC
TAGTCTCTCCGGATCGTAA -> AGTCTCTCCGGATCGTAAC
TAGTTCAATTTTCTTCTGG -> AGTTCAATTTTCTTCTGGG
TAGTTCAGCGCGCACGAGC -> AGTTCAGCGCGCACGAGCG
TATAACACATACATGAAAC -> ATAACACATACATGAAACC
TATACTTGTCCTCTCTACA -> ATACTTGTCCTCTCTACAT
TATAGGGACGGTCCTCACA -> ATAGGGACGGTCCTCACAC
TATATCATCCAACAGTCCT -> ATATCATCCAACAGTCCTA
TATATCGGAGCGATCCTAG -> ATATCGGAGCGATCCTAGT
TATATCGGAGCGATCCTCT -> ATATCGGAGCGATCCTCTT
TATATCGGAGCGATCCTGC -> ATATCGGAGCGATCCTGCT
TATATCGGAGCGATCCTTG -> ATATCGGAGCGATCCTTGG
TATATGGATCCGTCCCGAT -> ATATGGATCCGTCCCGATA
TATCACTCCTCAGTGTCGG -> ATCACTCCTCAGTGTCGGA
TATCAGACACACAGGGTCC -> ATCAGACACACAGGGTCCT
TATCATCCAACAGTCCTAA -> ATCATCCAACAGTCCTAAT
TATCATGTACTATCGTCCC -> ATCATGTACTATCGTCCCA
TATCATTTTAAAGGGAACT -> ATCATTTTAAAGGGAACTA
TATCCGGTCACAGGCATCG -> ATCCGGTCACAGGCATCGG
TATCCTGGCGGAGTTTTGC -> ATCCTGGCGGAGTTTTGCC
TATCCTGTCCGAGCAACCC -> ATCCTGTCCGAGCAACCCG
TATCGAAGGGCAGGACGAG -> ATCGAAGGGCAGGACGAGA
TATCGAGGATGTCGCGGAA -> ATCGAGGATGTCGCGGAAT
TATCGCCGACCAACCATAA -> ATCGCCGACCAACCATAAT
TATCGCTAGGAACAACCTC -> ATCGCTAGGAACAACCTCT
TATCGGAGCGATCCTAGTT -> ATCGGAGCGATCCTAGTTC
TATCGGAGCGATCCTCTTC -> ATCGGAGCGATCCTCTTCG
TATCGGAGCGATCCTGCTC -> ATCGGAGCGATCCTGCTCG
TATCGGAGCGATCCTTGGA -> ATCGGAGCGATCCTTGGAT
TATCGTCCCAAGCTGAGCG -> ATCGTCCCAAGCTGAGCGG
TATCGTTTTTAGCAAGTAC -> ATCGTTTTTAGCAAGTACT
TATCTCTGTTCCCGCGTTG -> ATCTCTGTTCCCGCGTTGC
TATGCAAGCTAGGTAGACC -> ATGCAAGCTAGGTAGACCT
TATGCATTTACCACATAGC -> ATGCATTTACCACATAGCT
TATGCTGTACCTCTACCCT -> ATGCTGTACCTCTACCCTA
TATGGATCCGTCCCGATAC -> ATGGATCCGTCCCGATACG
TATGGCCCTTTGCTCCCCT -> ATGGCCCTTTGCTCCCCTA
TATGGCCTTGCTTCTGGAA -> ATGGCCTTGCTTCTGGAAT
TATGGGGCAACGGCTTCAA -> ATGGGGCAACGGCTTCAAA
TATGGGTTTATGGCCCTTT -> ATGGGTTTATGGCCCTTTG
TATTACGCGGGGGATAAAA -> ATTACGCGGGGGATAAAAA
TATTCTACCGTTTGACCTC -> ATTCTACCGTTTGACCTCT
TATTTAGATAAGTTCTATA -> ATTTAGATAAGTTCTATAT
TATTTCCGTGGTAACCGAT -> ATTTCCGTGGTAACCGATG
TCAAAAATATCTCTGTTCC -> CAAAAATATCTCTGTTCCC
TCAAAGACCACCTATAACA -> CAAAGACCACCTATAACAC
TCAAAGTTGTGATTAATAT -> CAAAGTTGTGATTAATATC
TCAACAGGCGCACTACGGG -> CAACAGGCGCACTACGGGC
TCAACTTGGGCCTGACTCG -> CAACTTGGGCCTGACTCGA
TCAAGCCTCCTCGAGACGC -> CAAGCCTCCTCGAGACGCC
TCAATTTTCTTCTGGGTGG -> CAATTTTCTTCTGGGTGGT
TCAATTTTTCTCGCAAGCC -> CAATTTTTCTCGCAAGCCT
TCACAAACTGCTATATCAT -> CACAAACTGCTATATCATC
TCACACATATCCTGGCGGA -> CACACATATCCTGGCGGAG
TCACACGATTATGCAAGCT -> CACACGATTATGCAAGCTA
TCACACTAAGCGTGTTTAG -> CACACTAAGCGTGTTTAGT
TCACAGGCATCGGACAGCC -> CACAGGCATCGGACAGCCG
TCACAGTTCGTCGGATTAA -> CACAGTTCGTCGGATTAAG
TCACCATTTAGGAATTCGA -> CACCATTTAGGAATTCGAC
TCACGCGAGTGCTCTAATG -> CACGCGAGTGCTCTAATGA
TCACGTCACGCGAGTGCTC -> CACGTCACGCGAGTGCTCT
TCACTCCTCAGTGTCGGAC -> CACTCCTCAGTGTCGGACA
TCAGACACACAGGGTCCTT -> CAGACACACAGGGTCCTTG
TCAGAGCCTAGCTGTCGTG -> CAGAGCCTAGCTGTCGTGC
TCAGCCGCGGTTGGGCTGT -> CAGCCGCGGTTGGGCTGTA
TCAGCGCGCACGAGCGGGG -> CAGCGCGCACGAGCGGGGG
TCAGGCCGGCTATATCGGA -> CAGGCCGGCTATATCGGAG
TCAGTAGGAAGCAGCTTAG -> CAGTAGGAAGCAGCTTAGT
TCAGTCTACCCAGTGATCC -> CAGTCTACCCAGTGATCCT
TCAGTGTCGGACACAAGCT -> CAGTGTCGGACACAAGCTA
TCATAATTTTTTGGGCCGG -> CATAATTTTTTGGGCCGGC
TCATCCAACAGTCCTAATC -> CATCCAACAGTCCTAATCG
TCATGTACTATCGTCCCAA -> CATGTACTATCGTCCCAAG
TCATGTCCAGTGTTATAGG -> CATGTCCAGTGTTATAGGG
TCATTCTAGCTCGATGTAT -> CATTCTAGCTCGATGTATC
TCATTCTTTAGGCTAGAGA -> CATTCTTTAGGCTAGAGAC
TCATTTTAAAGGGAACTAC -> CATTTTAAAGGGAACTACC
TCCAACAGTCCTAATCGAG -> CCAACAGTCCTAATCGAGC
TCCAACGGCACTATTACGC -> CCAACGGCACTATTACGCG
TCCAATCACACATATCCTG -> CCAATCACACATATCCTGG
TCCACGGCAGTTCAACAGG -> CCACGGCAGTTCAACAGGC
TCCAGTAATTCGTACCCAA -> CCAGTAATTCGTACCCAAC
TCCAGTCCTTGTCACAGTT -> CCAGTCCTTGTCACAGTTC
TCCAGTGTTATAGGGACGG -> CCAGTGTTATAGGGACGGT
TCCCAAGCTGAGCGGCGCT -> CCCAAGCTGAGCGGCGCTG
TCCCCCGTTGGCAATTCAC -> CCCCCGTTGGCAATTCACC
TCCCCGTCCCCTTCCTGTC -> CCCCGTCCCCTTCCTGTCA
TCCCCTAAGACTACTACGG -> CCCCTAAGACTACTACGGA
TCCCCTTCCTGTCACGTCA -> CCCCTTCCTGTCACGTCAC
TCCCGATACGCATATGGGG -> CCCGATACGCATATGGGGC
TCCCGCGTTGCTAGAGCTA -> CCCGCGTTGCTAGAGCTAT
TCCCGTAGATGTTTCATAA -> CCCGTAGATGTTTCATAAT
TCCCTAGGCTGTATGCTGT -> CCCTAGGCTGTATGCTGTA
TCCCTGGCCACACGGTCCG -> CCCTGGCCACACGGTCCGC
TCCGAGCAACCCGAGGGGG -> CCGAGCAACCCGAGGGGGG
TCCGCATCTCCTGTCCCTA -> CCGCATCTCCTGTCCCTAG
TCCGCTGCCCGGCTAAACG -> CCGCTGCCCGGCTAAACGC
TCCGGATCGTAACCATAAG -> CCGGATCGTAACCATAAGT
TCCGGTCACAGGCATCGGA -> CCGGTCACAGGCATCGGAC
TCCGTCCCGATACGCATAT -> CCGTCCCGATACGCATATG
TCCGTGATGGAACGCGTGG -> CCGTGATGGAACGCGTGGA
TCCGTGGTAACCGATGGAT -> CCGTGGTAACCGATGGATA
TCCTAATCGAGCTACCAAC -> CCTAATCGAGCTACCAACG
TCCTAGTTCAATTTTCTTC -> CCTAGTTCAATTTTCTTCT
TCCTCAAAAATATCTCTGT -> CCTCAAAAATATCTCTGTT
TCCTCACACTAAGCGTGTT -> CCTCACACTAAGCGTGTTT
TCCTCAGTGTCGGACACAA -> CCTCAGTGTCGGACACAAG
TCCTCGAACGAGTCAGGCC -> CCTCGAACGAGTCAGGCCG
TCCTCGAGACGCCATTGCT -> CCTCGAGACGCCATTGCTG
TCCTCGGAAAACATGAGTT -> CCTCGGAAAACATGAGTTA
TCCTCGTTAATCAAGCCTC -> CCTCGTTAATCAAGCCTCC
TCCTCTCTACATTATCGAA -> CCTCTCTACATTATCGAAG
TCCTCTTCGAGAGCGCTTC -> CCTCTTCGAGAGCGCTTCT
TCCTGATTTAGGTACTATA -> CCTGATTTAGGTACTATAT
TCCTGCTCGGAGGGTCTTC -> CCTGCTCGGAGGGTCTTCT
TCCTGGCGGAGTTTTGCCG -> CCTGGCGGAGTTTTGCCGG
TCCTGTCACGTCACGCGAG -> CCTGTCACGTCACGCGAGT
TCCTGTCCCTAGGCTGTAT -> CCTGTCCCTAGGCTGTATG
TCCTGTCCGAGCAACCCGA -> CCTGTCCGAGCAACCCGAG
TCCTTATCAGACACACAGG -> CCTTATCAGACACACAGGG
TCCTTGAGCCTATATGGAT -> CCTTGAGCCTATATGGATC
TCCTTGGATCGACGTCTTC -> CCTTGGATCGACGTCTTCT
TCCTTGTAGATTAGGGCCT -> CCTTGTAGATTAGGGCCTA
TCCTTGTCACAGTTCGTCG -> CCTTGTCACAGTTCGTCGG
TCGAACGAGTCAGGCCGGC -> CGAACGAGTCAGGCCGGCT
TCGAAGGGCAGGACGAGAC -> CGAAGGGCAGGACGAGACA
TCGACACCCATCGGAGGCC -> CGACACCCATCGGAGGCCT
TCGACGTCTTCTGGGTGGT -> CGACGTCTTCTGGGTGGTT
TCGAGAATCAGTCTACCCA -> CGAGAATCAGTCTACCCAG
TCGAGACGCCATTGCTGCA -> CGAGACGCCATTGCTGCAG
TCGAGAGCGCTTCTGGGTG -> CGAGAGCGCTTCTGGGTGG
TCGAGCTACCAACGCAGGA -> CGAGCTACCAACGCAGGAC
TCGAGCTTCTGGTTAGAGA -> CGAGCTTCTGGTTAGAGAC
TCGAGGATGTCGCGGAATT -> CGAGGATGTCGCGGAATTT
TCGATGTATCCTGTCCGAG -> CGATGTATCCTGTCCGAGC
TCGATTGGTTTTGTTTACT -> CGATTGGTTTTGTTTACTA
TCGCAAGCCTGACCGGACA -> CGCAAGCCTGACCGGACAA
TCGCCGACCAACCATAATG -> CGCCGACCAACCATAATGT
TCGCCTTTAGAGATAGGCA -> CGCCTTTAGAGATAGGCAT
TCGCGCTCAGTAGGAAGCA -> CGCGCTCAGTAGGAAGCAG
TCGCGGAATTTCCTCGGAA -> CGCGGAATTTCCTCGGAAA
TCGCTAGGAACAACCTCTT -> CGCTAGGAACAACCTCTTC
TCGCTCGGATCCTCGTTAA -> CGCTCGGATCCTCGTTAAT
TCGCTTTACGCACTCGTCC -> CGCTTTACGCACTCGTCCA
TCGGAAAACATGAGTTATC -> CGGAAAACATGAGTTATCA
TCGGACACAAGCTAGGCAG -> CGGACACAAGCTAGGCAGC
TCGGACAGCCGTTTGTAGA -> CGGACAGCCGTTTGTAGAG
TCGGAGCGATCCTAGTTCA -> CGGAGCGATCCTAGTTCAA
TCGGAGCGATCCTCTTCGA -> CGGAGCGATCCTCTTCGAG
TCGGAGCGATCCTGCTCGG -> CGGAGCGATCCTGCTCGGA
TCGGAGCGATCCTTGGATC -> CGGAGCGATCCTTGGATCG
TCGGAGGCCTATTTAGATA -> CGGAGGCCTATTTAGATAA
TCGGAGGGTCTTCTGGGTG -> CGGAGGGTCTTCTGGGTGG
TCGGATCCTCGTTAATCAA -> CGGATCCTCGTTAATCAAG
TCGGATTAAGTCGCAGCGA -> CGGATTAAGTCGCAGCGAA
TCGGTCCCCGTCCCCTTCC -> CGGTCCCCGTCCCCTTCCT
TCGTAACCATAAGTGGCCG -> CGTAACCATAAGTGGCCGG
TCGTACCCAACAGTACCAT -> CGTACCCAACAGTACCATC
TCGTAGGCAACTGTCCGTG -> CGTAGGCAACTGTCCGTGA
TCGTCCAGTCCTTGTCACA -> CGTCCAGTCCTTGTCACAG
TCGTCCCAAGCTGAGCGGC -> CGTCCCAAGCTGAGCGGCG
TCGTCCTCGAACGAGTCAG -> CGTCCTCGAACGAGTCAGG
TCGTCGGATTAAGTCGCAG -> CGTCGGATTAAGTCGCAGC
TCGTCTAGCCAGTTTCCAG -> CGTCTAGCCAGTTTCCAGT
TCGTGCCATATCACTCCTC -> CGTGCCATATCACTCCTCA
TCGTGCGGTATCCGGTCAC -> CGTGCGGTATCCGGTCACA
TCGTTAATCAAGCCTCCTC -> CGTTAATCAAGCCTCCTCG
TCGTTCTCTGTCGCCTTTA -> CGTTCTCTGTCGCCTTTAG
TCGTTGTCTCGTCCTCGAA -> CGTTGTCTCGTCCTCGAAC
TCGTTTTTAGCAAGTACTT -> CGTTTTTAGCAAGTACTTC
TCGTTTTTCCAACGGCACT -> CGTTTTTCCAACGGCACTA
TCTAATGACATAATGTCTC -> CTAATGACATAATGTCTCG
TCTACATTATCGAAGGGCA -> CTACATTATCGAAGGGCAG
TCTACCCAGTGATCCTTAT -> CTACCCAGTGATCCTTATC
TCTACCCTATGGGTTTATG -> CTACCCTATGGGTTTATGG
TCTACCGTTTGACCTCTGC -> CTACCGTTTGACCTCTGCG
TCTAGAATCAGAGCCTAGC -> CTAGAATCAGAGCCTAGCT
TCTAGCCAGTTTCCAGTAA -> CTAGCCAGTTTCCAGTAAT
TCTAGCTCGATGTATCCTG -> CTAGCTCGATGTATCCTGT
TCTATATCGGAGCGATCCT -> CTATATCGGAGCGATCCTT
TCTCCGGATCGTAACCATA -> CTCCGGATCGTAACCATAA
TCTCCTGTCCCTAGGCTGT -> CTCCTGTCCCTAGGCTGTA
TCTCCTTGAGCCTATATGG -> CTCCTTGAGCCTATATGGA
TCTCGCAAGCCTGACCGGA -> CTCGCAAGCCTGACCGGAC
TCTCGCTTTACGCACTCGT -> CTCGCTTTACGCACTCGTC
TCTCGTCCTCGAACGAGTC -> CTCGTCCTCGAACGAGTCA
TCTCGTTGTCTCGTCCTCG -> CTCGTTGTCTCGTCCTCGA
TCTCTACATTATCGAAGGG -> CTCTACATTATCGAAGGGC
TCTCTCCGGATCGTAACCA -> CTCTCCGGATCGTAACCAT
TCTCTCTGGATCCCTGGCC -> CTCTCTGGATCCCTGGCCA
TCTCTGGATCCCTGGCCAC -> CTCTGGATCCCTGGCCACA
TCTCTGTCGCCTTTAGAGA -> CTCTGTCGCCTTTAGAGAT
TCTCTGTTCCCGCGTTGCT -> CTCTGTTCCCGCGTTGCTA
TCTGAAACTGTTGATTAAG -> CTGAAACTGTTGATTAAGT
TCTGAACCTGCATCATTCT -> CTGAACCTGCATCATTCTA
TCTGCGTCGTCTAGCCAGT -> CTGCGTCGTCTAGCCAGTT
TCTGGAATCATTCTTTAGG -> CTGGAATCATTCTTTAGGC
TCTGGATCCCTGGCCACAC -> CTGGATCCCTGGCCACACG
TCTGGGTGGTTGTGTTGAA -> CTGGGTGGTTGTGTTGAAC
TCTGGGTGGTTGTGTTGAT -> CTGGGTGGTTGTGTTGATC
TCTGGGTGGTTGTGTTGCA -> CTGGGTGGTTGTGTTGCAT
TCTGGGTGGTTGTGTTGTA -> CTGGGTGGTTGTGTTGTAA
TCTGGTGTGATATACTTGT -> CTGGTGTGATATACTTGTC
TCTGGTTAGAGACTTACTT -> CTGGTTAGAGACTTACTTC
TCTGTCGCCTTTAGAGATA -> CTGTCGCCTTTAGAGATAG
TCTGTTCCCGCGTTGCTAG -> CTGTTCCCGCGTTGCTAGA
TCTGTTTTTGCAATGACCA -> CTGTTTTTGCAATGACCAC
TCTTCAATTTTTCTCGCAA -> CTTCAATTTTTCTCGCAAG
TCTTCGAGAGCGCTTCTGG -> CTTCGAGAGCGCTTCTGGG
TCTTCTCTCTGGATCCCTG -> CTTCTCTCTGGATCCCTGG
TCTTCTGGGTGGTTGTGTT -> CTTCTGGGTGGTTGTGTTG,CTTCTGGGTGGTTGTGTTG,CTTCTGGGTGGTTGTGTTG
TCTTGAGATTTCTCGTTGT -> CTTGAGATTTCTCGTTGTC
TCTTTAGGCTAGAGACGCT -> CTTTAGGCTAGAGACGCTA
TCTTTCTTCTCTCTGGATC -> CTTTCTTCTCTCTGGATCC
TGAAACCTATATCGGAGCG -> GAAACCTATATCGGAGCGA
TGAAACTGTTGATTAAGTG -> GAAACTGTTGATTAAGTGT
TGAACCTGCATCATTCTAG -> GAACCTGCATCATTCTAGC
TGAACTACACACACCACGA -> GAACTACACACACCACGAA
TGACATAATGTCTCGCTTT -> GACATAATGTCTCGCTTTA
TGACCACCATTTAGAGGCG -> GACCACCATTTAGAGGCGC
TGACCCACCAGGTGGTAGA -> GACCCACCAGGTGGTAGAA
TGACCGGACAAAGGCCTCA -> GACCGGACAAAGGCCTCAC
TGACCTCTGCGTCGTCTAG -> GACCTCTGCGTCGTCTAGC
TGACTCCTCAAAAATATCT -> GACTCCTCAAAAATATCTC
TGACTCGAGCTTCTGGTTA -> GACTCGAGCTTCTGGTTAG
TGAGATTTCTCGTTGTCTC -> GAGATTTCTCGTTGTCTCG
TGAGCCTATATGGATCCGT -> GAGCCTATATGGATCCGTC
TGAGCGGCGCTGTCAAAGT -> GAGCGGCGCTGTCAAAGTT
TGAGGGACTTTTATTTCCG -> GAGGGACTTTTATTTCCGT
TGAGTTATCATTTTAAAGG -> GAGTTATCATTTTAAAGGG
TGATATACTTGTCCTCTCT -> GATATACTTGTCCTCTCTA
TGATCCTTATCAGACACAC -> GATCCTTATCAGACACACA
TGATCGATTGGTTTTGTTT -> GATCGATTGGTTTTGTTTA
TGATGGAACGCGTGGATCA -> GATGGAACGCGTGGATCAT
TGATTAAGTGTCGAGAATC -> GATTAAGTGTCGAGAATCA
TGATTAATATCGCCGACCA -> GATTAATATCGCCGACCAA
TGATTTAGGTACTATATCG -> GATTTAGGTACTATATCGG
TGCAAGCTAGGTAGACCTC -> GCAAGCTAGGTAGACCTCC
TGCAATGACCACCATTTAG -> GCAATGACCACCATTTAGA
TGCACTTAGAGACCCATAG -> GCACTTAGAGACCCATAGG
TGCAGAAAGGGACCCCGCG -> GCAGAAAGGGACCCCGCGA
TGCAGCTTCTGTTTTTGCA -> GCAGCTTCTGTTTTTGCAA
TGCAGTCGGTCCCCGTCCC -> GCAGTCGGTCCCCGTCCCC
TGCATAGAAGGTAAAGCCG -> GCATAGAAGGTAAAGCCGT
TGCATCATTCTAGCTCGAT -> GCATCATTCTAGCTCGATG
TGCATTTACCACATAGCTA -> GCATTTACCACATAGCTAG
TGCCATATCACTCCTCAGT -> GCCATATCACTCCTCAGTG
TGCCCCCGACGGTTCGCGC -> GCCCCCGACGGTTCGCGCT
TGCCCGGCTAAACGCCCGC -> GCCCGGCTAAACGCCCGCC
TGCCGGCTATCATGTACTA -> GCCGGCTATCATGTACTAT
TGCGGTATCCGGTCACAGG -> GCGGTATCCGGTCACAGGC
TGCGTCGTCTAGCCAGTTT -> GCGTCGTCTAGCCAGTTTC
TGCTAGAGCTATTCTACCG -> GCTAGAGCTATTCTACCGT
TGCTATATCATCCAACAGT -> GCTATATCATCCAACAGTC
TGCTCCCCTAAGACTACTA -> GCTCCCCTAAGACTACTAC
TGCTCGGAGGGTCTTCTGG -> GCTCGGAGGGTCTTCTGGG
TGCTCTAATGACATAATGT -> GCTCTAATGACATAATGTC
TGCTCTTTCTTCTCTCTGG -> GCTCTTTCTTCTCTCTGGA
TGCTGCAGTCGGTCCCCGT -> GCTGCAGTCGGTCCCCGTC
TGCTGTACCTCTACCCTAT -> GCTGTACCTCTACCCTATG
TGCTTCTGGAATCATTCTT -> GCTTCTGGAATCATTCTTT
TGGAACGCGTGGATCATGT -> GGAACGCGTGGATCATGTC
TGGAATCATTCTTTAGGCT -> GGAATCATTCTTTAGGCTA
TGGATAACGCATTGACTCC -> GGATAACGCATTGACTCCT
TGGATCATGTCCAGTGTTA -> GGATCATGTCCAGTGTTAT
TGGATCCCTGGCCACACGG -> GGATCCCTGGCCACACGGT
TGGATCCGTCCCGATACGC -> GGATCCGTCCCGATACGCA
TGGATCGACGTCTTCTGGG -> GGATCGACGTCTTCTGGGT
TGGCAATTCACCATTTAGG -> GGCAATTCACCATTTAGGA
TGGCCACACGGTCCGCTGC -> GGCCACACGGTCCGCTGCC
TGGCCCTTTGCTCCCCTAA -> GGCCCTTTGCTCCCCTAAG
TGGCCGGACGTAAAAATCA -> GGCCGGACGTAAAAATCAA
TGGCCTTGCTTCTGGAATC -> GGCCTTGCTTCTGGAATCA
TGGCGGAGTTTTGCCGGCT -> GGCGGAGTTTTGCCGGCTA
TGGGCAACTTACGCATACC -> GGGCAACTTACGCATACCA
TGGGCACGGGAAGGTTATG -> GGGCACGGGAAGGTTATGC
TGGGCCGGCCCAGTCCGCA -> GGGCCGGCCCAGTCCGCAT
TGGGCCTGACTCGAGCTTC -> GGGCCTGACTCGAGCTTCT
TGGGCTGTATCGAGGATGT -> GGGCTGTATCGAGGATGTC
TGGGGCAACGGCTTCAAAG -> GGGGCAACGGCTTCAAAGA
TGGGTGGTTGTGTTGAACT -> GGGTGGTTGTGTTGAACTA
TGGGTGGTTGTGTTGATCG -> GGGTGGTTGTGTTGATCGA
TGGGTGGTTGTGTTGCATA -> GGGTGGTTGTGTTGCATAG
TGGGTGGTTGTGTTGTAAT -> GGGTGGTTGTGTTGTAATG
TGGGTTTATGGCCCTTTGC -> GGGTTTATGGCCCTTTGCT
TGGTAACCGATGGATAACG -> GGTAACCGATGGATAACGC
TGGTAGAATCTGAAACTGT -> GGTAGAATCTGAAACTGTT
TGGTGTGATATACTTGTCC -> GGTGTGATATACTTGTCCT
TGGTTAGAGACTTACTTCC -> GGTTAGAGACTTACTTCCA
TGGTTGTGTTGAACTACAC -> GGTTGTGTTGAACTACACA
TGGTTGTGTTGATCGATTG -> GGTTGTGTTGATCGATTGG
TGGTTGTGTTGCATAGAAG -> GGTTGTGTTGCATAGAAGG
TGGTTGTGTTGTAATGTAA -> GGTTGTGTTGTAATGTAAG
TGGTTTTGTTTACTAGAAG -> GGTTTTGTTTACTAGAAGC
TGTAAGCAATTTTTTGCAG -> GTAAGCAATTTTTTGCAGC
TGTAATGTAAGCAATTTTT -> GTAATGTAAGCAATTTTTT
TGTACCTCTACCCTATGGG -> GTACCTCTACCCTATGGGT
TGTACGTTGAGGGACTTTT -> GTACGTTGAGGGACTTTTA
TGTACTATCGTCCCAAGCT -> GTACTATCGTCCCAAGCTG
TGTAGAGCTGGGCACGGGA -> GTAGAGCTGGGCACGGGAA
TGTAGATTAGGGCCTATGG -> GTAGATTAGGGCCTATGGC
TGTATCCTGTCCGAGCAAC -> GTATCCTGTCCGAGCAACC
TGTATCGAGGATGTCGCGG -> GTATCGAGGATGTCGCGGA
TGTATGCTGTACCTCTACC -> GTATGCTGTACCTCTACCC
TGTCAAAGTTGTGATTAAT -> GTCAAAGTTGTGATTAATA
TGTCACAGTTCGTCGGATT -> GTCACAGTTCGTCGGATTA
TGTCACGTCACGCGAGTGC -> GTCACGTCACGCGAGTGCT
TGTCCAGTGTTATAGGGAC -> GTCCAGTGTTATAGGGACG
TGTCCCTAGGCTGTATGCT -> GTCCCTAGGCTGTATGCTG
TGTCCGAGCAACCCGAGGG -> GTCCGAGCAACCCGAGGGG
TGTCCGTGATGGAACGCGT -> GTCCGTGATGGAACGCGTG
TGTCCTCTCTACATTATCG -> GTCCTCTCTACATTATCGA
TGTCGAGAATCAGTCTACC -> GTCGAGAATCAGTCTACCC
TGTCGCCTTTAGAGATAGG -> GTCGCCTTTAGAGATAGGC
TGTCGCGGAATTTCCTCGG -> GTCGCGGAATTTCCTCGGA
TGTCGGACACAAGCTAGGC -> GTCGGACACAAGCTAGGCA
TGTCGTGCCATATCACTCC -> GTCGTGCCATATCACTCCT
TGTCTCGCTTTACGCACTC -> GTCTCGCTTTACGCACTCG
TGTCTCGTCCTCGAACGAG -> GTCTCGTCCTCGAACGAGT
TGTGATATACTTGTCCTCT -> GTGATATACTTGTCCTCTC
TGTGATTAATATCGCCGAC -> GTGATTAATATCGCCGACC
TGTGTTGAACTACACACAC -> GTGTTGAACTACACACACC
TGTGTTGATCGATTGGTTT -> GTGTTGATCGATTGGTTTT
TGTGTTGCATAGAAGGTAA -> GTGTTGCATAGAAGGTAAA
TGTGTTGTAATGTAAGCAA -> GTGTTGTAATGTAAGCAAT
TGTTATAGGGACGGTCCTC -> GTTATAGGGACGGTCCTCA
TGTTCCCGCGTTGCTAGAG -> GTTCCCGCGTTGCTAGAGC
TGTTGAACTACACACACCA -> GTTGAACTACACACACCAC
TGTTGATCGATTGGTTTTG -> GTTGATCGATTGGTTTTGT
TGTTGATTAAGTGTCGAGA -> GTTGATTAAGTGTCGAGAA
TGTTGCATAGAAGGTAAAG -> GTTGCATAGAAGGTAAAGC
TGTTGTAATGTAAGCAATT -> GTTGTAATGTAAGCAATTT
TGTTTACTAGAAGCGAATG -> GTTTACTAGAAGCGAATGT
TGTTTAGTCTCTCCGGATC -> GTTTAGTCTCTCCGGATCG
TGTTTCATAATTTTTTGGG -> GTTTCATAATTTTTTGGGC
TGTTTGCAGAAAGGGACCC -> GTTTGCAGAAAGGGACCCC
TGTTTTCTGAACCTGCATC -> GTTTTCTGAACCTGCATCA
TGTTTTTGCAATGACCACC -> GTTTTTGCAATGACCACCA
TTAAAGGGAACTACCCCTG -> TAAAGGGAACTACCCCTGT
TTAAGTCGCAGCGAAGAGA -> TAAGTCGCAGCGAAGAGAC
TTAAGTGTCGAGAATCAGT -> TAAGTGTCGAGAATCAGTC
TTAATATCGCCGACCAACC -> TAATATCGCCGACCAACCA
TTAATCAAGCCTCCTCGAG -> TAATCAAGCCTCCTCGAGA
TTACCACATAGCTAGAGGG -> TACCACATAGCTAGAGGGG
TTACGCACTCGTCCAGTCC -> TACGCACTCGTCCAGTCCT
TTACGCATACCATTACTGA -> TACGCATACCATTACTGAC
TTACGCGGGGGATAAAAAC -> TACGCGGGGGATAAAAACC
TTACTAGAAGCGAATGTTT -> TACTAGAAGCGAATGTTTG
TTACTGACCCACCAGGTGG -> TACTGACCCACCAGGTGGT
TTACTTCCACGGCAGTTCA -> TACTTCCACGGCAGTTCAA
TTAGAGACCCATAGGTCGT -> TAGAGACCCATAGGTCGTT
TTAGAGACTTACTTCCACG -> TAGAGACTTACTTCCACGG
TTAGAGATAGGCATTCGTG -> TAGAGATAGGCATTCGTGC
TTAGAGGCGCAGAGACAAT -> TAGAGGCGCAGAGACAATT
TTAGATAAGTTCTATATCG -> TAGATAAGTTCTATATCGG
TTAGCAAGTACTTCTGGTG -> TAGCAAGTACTTCTGGTGT
TTAGGAATTCGACACCCAT -> TAGGAATTCGACACCCATC
TTAGGCTAGAGACGCTATC -> TAGGCTAGAGACGCTATCG
TTAGGGCCTATGGCCTTGC -> TAGGGCCTATGGCCTTGCT
TTAGGTACTATATCGGAGC -> TAGGTACTATATCGGAGCG
TTAGTCTCTCCGGATCGTA -> TAGTCTCTCCGGATCGTAA
TTAGTTCAGCGCGCACGAG -> TAGTTCAGCGCGCACGAGC
TTATAGGGACGGTCCTCAC -> TATAGGGACGGTCCTCACA
TTATCAGACACACAGGGTC -> TATCAGACACACAGGGTCC
TTATCATTTTAAAGGGAAC -> TATCATTTTAAAGGGAACT
TTATCGAAGGGCAGGACGA -> TATCGAAGGGCAGGACGAG
TTATGCAAGCTAGGTAGAC -> TATGCAAGCTAGGTAGACC
TTATGCATTTACCACATAG -> TATGCATTTACCACATAGC
TTATGGCCCTTTGCTCCCC -> TATGGCCCTTTGCTCCCCT
TTATTTCCGTGGTAACCGA -> TATTTCCGTGGTAACCGAT
TTCAAAGACCACCTATAAC -> TCAAAGACCACCTATAACA
TTCAACAGGCGCACTACGG -> TCAACAGGCGCACTACGGG
TTCAATTTTCTTCTGGGTG -> TCAATTTTCTTCTGGGTGG
TTCAATTTTTCTCGCAAGC -> TCAATTTTTCTCGCAAGCC
TTCACCATTTAGGAATTCG -> TCACCATTTAGGAATTCGA
TTCAGCCGCGGTTGGGCTG -> TCAGCCGCGGTTGGGCTGT
TTCAGCGCGCACGAGCGGG -> TCAGCGCGCACGAGCGGGG
TTCATAATTTTTTGGGCCG -> TCATAATTTTTTGGGCCGG
TTCCAACGGCACTATTACG -> TCCAACGGCACTATTACGC
TTCCACGGCAGTTCAACAG -> TCCACGGCAGTTCAACAGG
TTCCAGTAATTCGTACCCA -> TCCAGTAATTCGTACCCAA
TTCCCCCGTTGGCAATTCA -> TCCCCCGTTGGCAATTCAC
TTCCCGCGTTGCTAGAGCT -> TCCCGCGTTGCTAGAGCTA
TTCCGTGGTAACCGATGGA -> TCCGTGGTAACCGATGGAT
TTCCTCGGAAAACATGAGT -> TCCTCGGAAAACATGAGTT
TTCCTGTCACGTCACGCGA -> TCCTGTCACGTCACGCGAG
TTCGACACCCATCGGAGGC -> TCGACACCCATCGGAGGCC
TTCGAGAGCGCTTCTGGGT -> TCGAGAGCGCTTCTGGGTG
TTCGCGCTCAGTAGGAAGC -> TCGCGCTCAGTAGGAAGCA
TTCGCTCGGATCCTCGTTA -> TCGCTCGGATCCTCGTTAA
TTCGTACCCAACAGTACCA -> TCGTACCCAACAGTACCAT
TTCGTAGGCAACTGTCCGT -> TCGTAGGCAACTGTCCGTG
TTCGTCGGATTAAGTCGCA -> TCGTCGGATTAAGTCGCAG
TTCGTGCGGTATCCGGTCA -> TCGTGCGGTATCCGGTCAC
TTCTACCGTTTGACCTCTG -> TCTACCGTTTGACCTCTGC
TTCTAGCTCGATGTATCCT -> TCTAGCTCGATGTATCCTG
TTCTATATCGGAGCGATCC -> TCTATATCGGAGCGATCCT
TTCTCGCAAGCCTGACCGG -> TCTCGCAAGCCTGACCGGA
TTCTCGTTGTCTCGTCCTC -> TCTCGTTGTCTCGTCCTCG
TTCTCTCTGGATCCCTGGC -> TCTCTCTGGATCCCTGGCC
TTCTCTGTCGCCTTTAGAG -> TCTCTGTCGCCTTTAGAGA
TTCTGAACCTGCATCATTC -> TCTGAACCTGCATCATTCT
TTCTGGAATCATTCTTTAG -> TCTGGAATCATTCTTTAGG
TTCTGGGTGGTTGTGTTGA -> TCTGGGTGGTTGTGTTGAA,TCTGGGTGGTTGTGTTGAT
TTCTGGGTGGTTGTGTTGC -> TCTGGGTGGTTGTGTTGCA
TTCTGGGTGGTTGTGTTGT -> TCTGGGTGGTTGTGTTGTA
TTCTGGTGTGATATACTTG -> TCTGGTGTGATATACTTGT
TTCTGGTTAGAGACTTACT -> TCTGGTTAGAGACTTACTT
TTCTGTTTTTGCAATGACC -> TCTGTTTTTGCAATGACCA
TTCTTCTCTCTGGATCCCT -> TCTTCTCTCTGGATCCCTG
TTCTTCTGGGTGGTTGTGT -> TCTTCTGGGTGGTTGTGTT
TTCTTTAGGCTAGAGACGC -> TCTTTAGGCTAGAGACGCT
TTGAACTACACACACCACG -> TGAACTACACACACCACGA
TTGACCTCTGCGTCGTCTA -> TGACCTCTGCGTCGTCTAG
TTGACTCCTCAAAAATATC -> TGACTCCTCAAAAATATCT
TTGAGATTTCTCGTTGTCT -> TGAGATTTCTCGTTGTCTC
TTGAGCCTATATGGATCCG -> TGAGCCTATATGGATCCGT
TTGAGGGACTTTTATTTCC -> TGAGGGACTTTTATTTCCG
TTGATCGATTGGTTTTGTT -> TGATCGATTGGTTTTGTTT
TTGATTAAGTGTCGAGAAT -> TGATTAAGTGTCGAGAATC
TTGCAATGACCACCATTTA -> TGCAATGACCACCATTTAG
TTGCAGAAAGGGACCCCGC -> TGCAGAAAGGGACCCCGCG
TTGCAGCTTCTGTTTTTGC -> TGCAGCTTCTGTTTTTGCA
TTGCATAGAAGGTAAAGCC -> TGCATAGAAGGTAAAGCCG
TTGCCGGCTATCATGTACT -> TGCCGGCTATCATGTACTA
TTGCTAGAGCTATTCTACC -> TGCTAGAGCTATTCTACCG
TTGCTCCCCTAAGACTACT -> TGCTCCCCTAAGACTACTA
TTGCTGCAGTCGGTCCCCG -> TGCTGCAGTCGGTCCCCGT
TTGCTTCTGGAATCATTCT -> TGCTTCTGGAATCATTCTT
TTGGATCGACGTCTTCTGG -> TGGATCGACGTCTTCTGGG
TTGGCAATTCACCATTTAG -> TGGCAATTCACCATTTAGG
TTGGGCCGGCCCAGTCCGC -> TGGGCCGGCCCAGTCCGCA
TTGGGCCTGACTCGAGCTT -> TGGGCCTGACTCGAGCTTC
TTGGGCTGTATCGAGGATG -> TGGGCTGTATCGAGGATGT
TTGGTTTTGTTTACTAGAA -> TGGTTTTGTTTACTAGAAG
TTGTAATGTAAGCAATTTT -> TGTAATGTAAGCAATTTTT
TTGTAGAGCTGGGCACGGG -> TGTAGAGCTGGGCACGGGA
TTGTAGATTAGGGCCTATG -> TGTAGATTAGGGCCTATGG
TTGTCACAGTTCGTCGGAT -> TGTCACAGTTCGTCGGATT
TTGTCCTCTCTACATTATC -> TGTCCTCTCTACATTATCG
TTGTCTCGTCCTCGAACGA -> TGTCTCGTCCTCGAACGAG
TTGTGATTAATATCGCCGA -> TGTGATTAATATCGCCGAC
TTGTGTTGAACTACACACA -> TGTGTTGAACTACACACAC
TTGTGTTGATCGATTGGTT -> TGTGTTGATCGATTGGTTT
TTGTGTTGCATAGAAGGTA -> TGTGTTGCATAGAAGGTAA
TTGTGTTGTAATGTAAGCA -> TGTGTTGTAATGTAAGCAA
TTGTTTACTAGAAGCGAAT -> TGTTTACTAGAAGCGAATG
TTTAAAGGGAACTACCCCT -> TTAAAGGGAACTACCCCTG
TTTACCACATAGCTAGAGG -> TTACCACATAGCTAGAGGG
TTTACGCACTCGTCCAGTC -> TTACGCACTCGTCCAGTCC
TTTACTAGAAGCGAATGTT -> TTACTAGAAGCGAATGTTT
TTTAGAGATAGGCATTCGT -> TTAGAGATAGGCATTCGTG
TTTAGAGGCGCAGAGACAA -> TTAGAGGCGCAGAGACAAT
TTTAGATAAGTTCTATATC -> TTAGATAAGTTCTATATCG
TTTAGCAAGTACTTCTGGT -> TTAGCAAGTACTTCTGGTG
TTTAGGAATTCGACACCCA -> TTAGGAATTCGACACCCAT
TTTAGGCTAGAGACGCTAT -> TTAGGCTAGAGACGCTATC
TTTAGGTACTATATCGGAG -> TTAGGTACTATATCGGAGC
TTTAGTCTCTCCGGATCGT -> TTAGTCTCTCCGGATCGTA
TTTATGGCCCTTTGCTCCC -> TTATGGCCCTTTGCTCCCC
TTTATTTCCGTGGTAACCG -> TTATTTCCGTGGTAACCGA
TTTCAGCCGCGGTTGGGCT -> TTCAGCCGCGGTTGGGCTG
TTTCATAATTTTTTGGGCC -> TTCATAATTTTTTGGGCCG
TTTCCAACGGCACTATTAC -> TTCCAACGGCACTATTACG
TTTCCAGTAATTCGTACCC -> TTCCAGTAATTCGTACCCA
TTTCCGTGGTAACCGATGG -> TTCCGTGGTAACCGATGGA
TTTCCTCGGAAAACATGAG -> TTCCTCGGAAAACATGAGT
TTTCGCTCGGATCCTCGTT -> TTCGCTCGGATCCTCGTTA
TTTCTCGCAAGCCTGACCG -> TTCTCGCAAGCCTGACCGG
TTTCTCGTTGTCTCGTCCT -> TTCTCGTTGTCTCGTCCTC
TTTCTGAACCTGCATCATT -> TTCTGAACCTGCATCATTC
TTTCTTCTCTCTGGATCCC -> TTCTTCTCTCTGGATCCCT
TTTCTTCTGGGTGGTTGTG -> TTCTTCTGGGTGGTTGTGT
TTTGACCTCTGCGTCGTCT -> TTGACCTCTGCGTCGTCTA
TTTGCAATGACCACCATTT -> TTGCAATGACCACCATTTA
TTTGCAGAAAGGGACCCCG -> TTGCAGAAAGGGACCCCGC
TTTGCAGCTTCTGTTTTTG -> TTGCAGCTTCTGTTTTTGC
TTTGCCGGCTATCATGTAC -> TTGCCGGCTATCATGTACT
TTTGCTCCCCTAAGACTAC -> TTGCTCCCCTAAGACTACT
TTTGGGCCGGCCCAGTCCG -> TTGGGCCGGCCCAGTCCGC
TTTGTAGAGCTGGGCACGG -> TTGTAGAGCTGGGCACGGG
TTTGTTTACTAGAAGCGAA -> TTGTTTACTAGAAGCGAAT
TTTTAAAGGGAACTACCCC -> TTTAAAGGGAACTACCCCT
TTTTAGCAAGTACTTCTGG -> TTTAGCAAGTACTTCTGGT
TTTTATTTCCGTGGTAACC -> TTTATTTCCGTGGTAACCG
TTTTCCAACGGCACTATTA -> TTTCCAACGGCACTATTAC
TTTTCTCGCAAGCCTGACC -> TTTCTCGCAAGCCTGACCG
TTTTCTGAACCTGCATCAT -> TTTCTGAACCTGCATCATT
TTTTCTTCTGGGTGGTTGT -> TTTCTTCTGGGTGGTTGTG
TTTTGCAATGACCACCATT -> TTTGCAATGACCACCATTT
TTTTGCAGCTTCTGTTTTT -> TTTGCAGCTTCTGTTTTTG
TTTTGCCGGCTATCATGTA -> TTTGCCGGCTATCATGTAC
TTTTGGGCCGGCCCAGTCC -> TTTGGGCCGGCCCAGTCCG
TTTTGTTTACTAGAAGCGA -> TTTGTTTACTAGAAGCGAA
TTTTTAGCAAGTACTTCTG -> TTTTAGCAAGTACTTCTGG
TTTTTCCAACGGCACTATT -> TTTTCCAACGGCACTATTA
TTTTTCTCGCAAGCCTGAC -> TTTTCTCGCAAGCCTGACC
TTTTTGCAATGACCACCAT -> TTTTGCAATGACCACCATT
TTTTTGCAGCTTCTGTTTT -> TTTTGCAGCTTCTGTTTTT
TTTTTGGGCCGGCCCAGTC -> TTTTGGGCCGGCCCAGTCC
TTTTTTGCAGCTTCTGTTT -> TTTTTGCAGCTTCTGTTTT
TTTTTTGGGCCGGCCCAGT -> TTTTTGGGCCGGCCCAGTC
